日期,管制站,入境 / 出境,香港居民,内地访客,其他访客,总计
2019-04-04,机场,入境,29331,15048,32239,76618
2019-04-04,机场,出境,48963,11905,21276,82144
2019-04-04,高铁西九龙,入境,7063,17165,1557,25785
2019-04-04,高铁西九龙,出境,20618,9134,873,30625
2019-04-04,红磡,入境,1871,1123,402,3396
2019-04-04,红磡,出境,4581,920,318,5819
2019-04-04,罗湖,入境,75438,22606,1957,100001
2019-04-04,罗湖,出境,158537,24415,1933,184885
2019-04-04,落马洲支线,入境,45863,21225,894,67982
2019-04-04,落马洲支线,出境,64735,19131,655,84521
2019-04-04,港珠澳大桥,入境,10268,7215,3396,20879
2019-04-04,港珠澳大桥,出境,23082,9213,3886,36181
2019-04-04,落马洲,入境,24220,9707,1557,35484
2019-04-04,落马洲,出境,32913,6883,873,40669
2019-04-04,文锦渡,入境,3538,1601,42,5181
2019-04-04,文锦渡,出境,4715,1341,57,6113
2019-04-04,沙头角,入境,3035,873,214,4122
2019-04-04,沙头角,出境,5414,784,116,6314
2019-04-04,深圳湾,入境,28058,18747,2348,49153
2019-04-04,深圳湾,出境,58317,18170,1523,78010
2019-04-04,中国客运码头,入境,2617,1448,1621,5686
2019-04-04,中国客运码头,出境,6263,1742,1534,9539
2019-04-04,港口管制,入境,1,0,156,157
2019-04-04,港口管制,出境,2,0,7,9
2019-04-04,启德邮轮码头,入境,622,173,28,823
2019-04-04,启德邮轮码头,出境,578,135,60,773
2019-04-04,港澳客轮码头,入境,9137,3465,4667,17269
2019-04-04,港澳客轮码头,出境,12921,1413,3968,18302
2019-04-04,屯门客运码头,入境,579,11,32,622
2019-04-04,屯门客运码头,出境,882,19,19,920
2019-04-05,机场,入境,26473,15022,28019,69514
2019-04-05,机场,出境,36156,10175,21923,68254
2019-04-05,高铁西九龙,入境,8611,39301,2005,49917
2019-04-05,高铁西九龙,出境,19026,20803,1028,40857
2019-04-05,红磡,入境,2820,2406,513,5739
2019-04-05,红磡,出境,5245,1205,341,6791
2019-04-05,罗湖,入境,116763,48377,2332,167472
2019-04-05,罗湖,出境,126522,49229,2165,177916
2019-04-05,落马洲支线,入境,57172,54625,1047,112844
2019-04-05,落马洲支线,出境,64797,45106,793,110696
2019-04-05,港珠澳大桥,入境,21630,13976,5692,41298
2019-04-05,港珠澳大桥,出境,30200,17421,5440,53061
2019-04-05,落马洲,入境,31161,12980,1262,45403
2019-04-05,落马洲,出境,31262,12183,832,44277
2019-04-05,文锦渡,入境,2251,4203,91,6545
2019-04-05,文锦渡,出境,2772,2678,61,5511
2019-04-05,沙头角,入境,4227,2097,165,6489
2019-04-05,沙头角,出境,5077,1289,78,6444
2019-04-05,深圳湾,入境,40928,40828,2188,83944
2019-04-05,深圳湾,出境,49773,34222,1506,85501
2019-04-05,中国客运码头,入境,3607,3088,1632,8327
2019-04-05,中国客运码头,出境,7095,2258,1601,10954
2019-04-05,港口管制,入境,23,0,140,163
2019-04-05,港口管制,出境,1,4,6,11
2019-04-05,启德邮轮码头,入境,1071,3598,870,5539
2019-04-05,启德邮轮码头,出境,3543,3971,344,7858
2019-04-05,港澳客轮码头,入境,13230,2094,5888,21212
2019-04-05,港澳客轮码头,出境,14860,2114,3883,20857
2019-04-05,屯门客运码头,入境,1190,21,61,1272
2019-04-05,屯门客运码头,出境,1500,21,34,1555
2019-04-06,机场,入境,33868,11514,25451,70833
2019-04-06,机场,出境,26966,12658,25204,64828
2019-04-06,高铁西九龙,入境,13517,32986,1439,47942
2019-04-06,高铁西九龙,出境,8403,29049,1166,38618
2019-04-06,红磡,入境,3099,1630,348,5077
2019-04-06,红磡,出境,2222,2039,378,4639
2019-04-06,罗湖,入境,107995,46596,2360,156951
2019-04-06,罗湖,出境,91518,58985,2567,153070
2019-04-06,落马洲支线,入境,49496,57220,1021,107737
2019-04-06,落马洲支线,出境,51143,57912,986,110041
2019-04-06,港珠澳大桥,入境,20781,15792,4833,41406
2019-04-06,港珠澳大桥,出境,19254,17894,4790,41938
2019-04-06,落马洲,入境,29620,11672,814,42106
2019-04-06,落马洲,出境,23474,12666,1073,37213
2019-04-06,文锦渡,入境,2001,4264,35,6300
2019-04-06,文锦渡,出境,2013,3294,38,5345
2019-04-06,沙头角,入境,3069,1996,130,5195
2019-04-06,沙头角,出境,2685,1553,164,4402
2019-04-06,深圳湾,入境,37567,41015,1942,80524
2019-04-06,深圳湾,出境,30135,42571,2256,74962
2019-04-06,中国客运码头,入境,4514,2796,1679,8989
2019-04-06,中国客运码头,出境,3318,3523,1667,8508
2019-04-06,港口管制,入境,8,0,46,54
2019-04-06,港口管制,出境,1,2,12,15
2019-04-06,启德邮轮码头,入境,624,339,35,998
2019-04-06,启德邮轮码头,出境,831,230,682,1743
2019-04-06,港澳客轮码头,入境,12723,2325,5293,20341
2019-04-06,港澳客轮码头,出境,11907,2510,4803,19220
2019-04-06,屯门客运码头,入境,923,49,57,1029
2019-04-06,屯门客运码头,出境,906,32,34,972
2019-04-07,机场,入境,51416,13499,22178,87093
2019-04-07,机场,出境,29332,16547,33015,78894
2019-04-07,高铁西九龙,入境,23788,14291,878,38957
2019-04-07,高铁西九龙,出境,5177,28620,1892,35689
2019-04-07,红磡,入境,5437,1404,293,7134
2019-04-07,红磡,出境,1546,2074,556,4176
2019-04-07,罗湖,入境,146316,26313,1774,174403
2019-04-07,罗湖,出境,69191,33734,2227,105152
2019-04-07,落马洲支线,入境,62183,27444,607,90234
2019-04-07,落马洲支线,出境,36968,31131,1046,69145
2019-04-07,港珠澳大桥,入境,31494,9876,4156,45526
2019-04-07,港珠澳大桥,出境,14405,12006,4923,31334
2019-04-07,落马洲,入境,39200,10546,692,50438
2019-04-07,落马洲,出境,18645,10640,1832,31117
2019-04-07,文锦渡,入境,2817,2428,36,5281
2019-04-07,文锦渡,出境,1516,2088,50,3654
2019-04-07,沙头角,入境,4531,1263,70,5864
2019-04-07,沙头角,出境,2280,1247,193,3720
2019-04-07,深圳湾,入境,58655,21734,1313,81702
2019-04-07,深圳湾,出境,22973,29817,3102,55892
2019-04-07,中国客运码头,入境,7271,1807,1193,10271
2019-04-07,中国客运码头,出境,2272,2427,1793,6492
2019-04-07,港口管制,入境,1,0,84,85
2019-04-07,港口管制,出境,1,1,26,28
2019-04-07,启德邮轮码头,入境,3748,771,2265,6784
2019-04-07,启德邮轮码头,出境,487,977,61,1525
2019-04-07,港澳客轮码头,入境,14749,1718,3679,20146
2019-04-07,港澳客轮码头,出境,8350,1418,4496,14264
2019-04-07,屯门客运码头,入境,1120,56,36,1212
2019-04-07,屯门客运码头,出境,743,29,37,809
2019-04-18,机场,入境,37783,12809,27943,78535
2019-04-18,机场,出境,80346,6535,17371,104252
2019-04-18,高铁西九龙,入境,7463,14217,2257,23937
2019-04-18,高铁西九龙,出境,31938,14298,1646,47882
2019-04-18,红磡,入境,1545,1167,691,3403
2019-04-18,红磡,出境,3916,1183,384,5483
2019-04-18,罗湖,入境,73239,24496,1856,99591
2019-04-18,罗湖,出境,122524,28958,2190,153672
2019-04-18,落马洲支线,入境,41032,21305,827,63164
2019-04-18,落马洲支线,出境,63481,20216,757,84454
2019-04-18,港珠澳大桥,入境,12686,9453,4795,26934
2019-04-18,港珠澳大桥,出境,27928,26476,4704,59108
2019-04-18,落马洲,入境,22798,15944,1440,40182
2019-04-18,落马洲,出境,30783,11279,1250,43312
2019-04-18,文锦渡,入境,2398,2425,34,4857
2019-04-18,文锦渡,出境,3160,1705,47,4912
2019-04-18,沙头角,入境,1985,874,109,2968
2019-04-18,沙头角,出境,3248,841,100,4189
2019-04-18,深圳湾,入境,25395,18373,2236,46004
2019-04-18,深圳湾,出境,51346,22183,1935,75464
2019-04-18,中国客运码头,入境,2657,1357,1632,5646
2019-04-18,中国客运码头,出境,5548,1973,1763,9284
2019-04-18,港口管制,入境,15,2,97,114
2019-04-18,港口管制,出境,3,3,31,37
2019-04-18,启德邮轮码头,入境,677,3276,103,4056
2019-04-18,启德邮轮码头,出境,4494,438,172,5104
2019-04-18,港澳客轮码头,入境,10586,1261,4806,16653
2019-04-18,港澳客轮码头,出境,15661,1531,4522,21714
2019-04-18,屯门客运码头,入境,824,15,41,880
2019-04-18,屯门客运码头,出境,1013,14,24,1051
2019-04-19,机场,入境,32979,12242,30750,75971
2019-04-19,机场,出境,73456,7406,21236,102098
2019-04-19,高铁西九龙,入境,7724,11831,2691,22246
2019-04-19,高铁西九龙,出境,47759,9999,998,58756
2019-04-19,红磡,入境,1483,1207,1007,3697
2019-04-19,红磡,出境,7147,765,258,8170
2019-04-19,罗湖,入境,84852,18499,2155,105506
2019-04-19,罗湖,出境,184063,21549,2415,208027
2019-04-19,落马洲支线,入境,48534,16086,769,65389
2019-04-19,落马洲支线,出境,114018,14541,702,129261
2019-04-19,港珠澳大桥,入境,18963,8731,6901,34595
2019-04-19,港珠澳大桥,出境,57076,20711,5726,83513
2019-04-19,落马洲,入境,24777,10659,1734,37170
2019-04-19,落马洲,出境,39692,7582,1129,48403
2019-04-19,文锦渡,入境,1323,1648,46,3017
2019-04-19,文锦渡,出境,3416,1336,126,4878
2019-04-19,沙头角,入境,1759,592,142,2493
2019-04-19,沙头角,出境,4770,559,116,5445
2019-04-19,深圳湾,入境,24803,13266,2772,40841
2019-04-19,深圳湾,出境,72830,13754,1665,88249
2019-04-19,中国客运码头,入境,2778,1217,1850,5845
2019-04-19,中国客运码头,出境,10636,1421,1417,13474
2019-04-19,港口管制,入境,1,0,104,105
2019-04-19,港口管制,出境,0,0,3,3
2019-04-19,启德邮轮码头,入境,1001,3043,47,4091
2019-04-19,启德邮轮码头,出境,3879,728,631,5238
2019-04-19,港澳客轮码头,入境,13216,1321,5367,19904
2019-04-19,港澳客轮码头,出境,21872,1487,4687,28046
2019-04-19,屯门客运码头,入境,1049,6,97,1152
2019-04-19,屯门客运码头,出境,1791,25,23,1839
2019-04-20,机场,入境,43572,12896,25898,82366
2019-04-20,机场,出境,44172,10732,28831,83735
2019-04-20,高铁西九龙,入境,12396,19531,2552,34479
2019-04-20,高铁西九龙,出境,24175,15840,1402,41417
2019-04-20,红磡,入境,2163,1251,648,4062
2019-04-20,红磡,出境,4594,1000,438,6032
2019-04-20,罗湖,入境,96913,30500,2665,130078
2019-04-20,罗湖,出境,120410,31567,2312,154289
2019-04-20,落马洲支线,入境,53428,33666,982,88076
2019-04-20,落马洲支线,出境,69004,30732,711,100447
2019-04-20,港珠澳大桥,入境,29980,15847,5741,51568
2019-04-20,港珠澳大桥,出境,36536,22396,5715,64647
2019-04-20,落马洲,入境,29161,13079,1522,43762
2019-04-20,落马洲,出境,25983,10404,1056,37443
2019-04-20,文锦渡,入境,1547,3188,77,4812
2019-04-20,文锦渡,出境,2007,1809,24,3840
2019-04-20,沙头角,入境,2430,1122,184,3736
2019-04-20,沙头角,出境,3397,918,82,4397
2019-04-20,深圳湾,入境,33155,27043,2906,63104
2019-04-20,深圳湾,出境,45603,27062,1764,74429
2019-04-20,中国客运码头,入境,4449,1503,1498,7450
2019-04-20,中国客运码头,出境,6131,1505,1624,9260
2019-04-20,港口管制,入境,2,1,159,162
2019-04-20,港口管制,出境,0,0,15,15
2019-04-20,启德邮轮码头,入境,911,192,3812,4915
2019-04-20,启德邮轮码头,出境,763,371,27,1161
2019-04-20,港澳客轮码头,入境,17119,1278,4844,23241
2019-04-20,港澳客轮码头,出境,16922,1643,4847,23412
2019-04-20,屯门客运码头,入境,1395,14,46,1455
2019-04-20,屯门客运码头,出境,1285,24,43,1352
2019-04-21,机场,入境,59308,11766,23072,94146
2019-04-21,机场,出境,39595,12921,34322,86838
2019-04-21,高铁西九龙,入境,26608,14750,1437,42795
2019-04-21,高铁西九龙,出境,13050,18736,2042,33828
2019-04-21,红磡,入境,5777,1235,355,7367
2019-04-21,红磡,出境,2079,1287,574,3940
2019-04-21,罗湖,入境,146295,29269,2410,177974
2019-04-21,罗湖,出境,96370,35486,2580,134436
2019-04-21,落马洲支线,入境,77898,36318,872,115088
2019-04-21,落马洲支线,出境,59928,33836,1011,94775
2019-04-21,港珠澳大桥,入境,44425,14458,5691,64574
2019-04-21,港珠澳大桥,出境,32780,20520,7052,60352
2019-04-21,落马洲,入境,41619,15990,979,58588
2019-04-21,落马洲,出境,24702,13886,1588,40176
2019-04-21,文锦渡,入境,2517,5454,127,8098
2019-04-21,文锦渡,出境,1678,2517,52,4247
2019-04-21,沙头角,入境,3729,1172,99,5000
2019-04-21,沙头角,出境,2786,1078,150,4014
2019-04-21,深圳湾,入境,66178,23812,1869,91859
2019-04-21,深圳湾,出境,34068,30006,2645,66719
2019-04-21,中国客运码头,入境,7999,1014,1156,10169
2019-04-21,中国客运码头,出境,4595,1681,1679,7955
2019-04-21,港口管制,入境,1,0,161,162
2019-04-21,港口管制,出境,10,0,5,15
2019-04-21,启德邮轮码头,入境,3827,922,996,5745
2019-04-21,启德邮轮码头,出境,2858,491,3093,6442
2019-04-21,港澳客轮码头,入境,21289,1248,4414,26951
2019-04-21,港澳客轮码头,出境,17532,1427,5153,24112
2019-04-21,屯门客运码头,入境,1481,21,46,1548
2019-04-21,屯门客运码头,出境,1462,13,59,1534
2019-04-22,机场,入境,82658,7251,17195,107104
2019-04-22,机场,出境,45399,9743,28011,83153
2019-04-22,高铁西九龙,入境,39940,9638,1082,50660
2019-04-22,高铁西九龙,出境,8266,7955,2418,18639
2019-04-22,红磡,入境,5440,840,277,6557
2019-04-22,红磡,出境,1598,743,1256,3597
2019-04-22,罗湖,入境,162235,22507,2020,186762
2019-04-22,罗湖,出境,75943,19584,1992,97519
2019-04-22,落马洲支线,入境,89471,19877,687,110035
2019-04-22,落马洲支线,出境,47412,13919,616,61947
2019-04-22,港珠澳大桥,入境,45025,10285,4357,59667
2019-04-22,港珠澳大桥,出境,19365,24762,5895,50022
2019-04-22,落马洲,入境,49762,14631,954,65347
2019-04-22,落马洲,出境,20822,7209,1341,29372
2019-04-22,文锦渡,入境,2800,2580,34,5414
2019-04-22,文锦渡,出境,1521,1166,18,2705
2019-04-22,沙头角,入境,4266,694,74,5034
2019-04-22,沙头角,出境,2225,463,109,2797
2019-04-22,深圳湾,入境,70670,14154,1618,86442
2019-04-22,深圳湾,出境,25069,12556,2107,39732
2019-04-22,中国客运码头,入境,9496,1060,1042,11598
2019-04-22,中国客运码头,出境,2842,1123,1567,5532
2019-04-22,港口管制,入境,2,44,87,133
2019-04-22,港口管制,出境,0,45,5,50
2019-04-22,启德邮轮码头,入境,643,368,27,1038
2019-04-22,启德邮轮码头,出境,493,318,1386,2197
2019-04-22,港澳客轮码头,入境,23368,1199,3868,28435
2019-04-22,港澳客轮码头,出境,9550,1221,4086,14857
2019-04-22,屯门客运码头,入境,1546,12,43,1601
2019-04-22,屯门客运码头,出境,787,20,49,856
2019-04-30,机场,入境,35253,18469,25397,79119
2019-04-30,机场,出境,25858,23605,27297,76760
2019-04-30,高铁西九龙,入境,7720,23753,1677,33150
2019-04-30,高铁西九龙,出境,5485,13655,1827,20967
2019-04-30,红磡,入境,2317,2007,401,4725
2019-04-30,红磡,出境,1837,1469,1361,4667
2019-04-30,罗湖,入境,80230,31198,2264,113692
2019-04-30,罗湖,出境,92340,28058,2163,122561
2019-04-30,落马洲支线,入境,47800,26062,853,74715
2019-04-30,落马洲支线,出境,51565,20598,576,72739
2019-04-30,港珠澳大桥,入境,11523,10152,3390,25065
2019-04-30,港珠澳大桥,出境,12047,13241,3406,28694
2019-04-30,落马洲,入境,25022,12827,1755,39604
2019-04-30,落马洲,出境,25689,9158,974,35821
2019-04-30,文锦渡,入境,3429,2289,61,5779
2019-04-30,文锦渡,出境,3815,1661,47,5523
2019-04-30,沙头角,入境,2891,1366,177,4434
2019-04-30,沙头角,出境,2911,849,85,3845
2019-04-30,深圳湾,入境,31337,27070,2350,60757
2019-04-30,深圳湾,出境,29728,20107,1764,51599
2019-04-30,中国客运码头,入境,2630,2159,1831,6620
2019-04-30,中国客运码头,出境,2112,2172,1926,6210
2019-04-30,港口管制,入境,6,0,92,98
2019-04-30,港口管制,出境,1,0,14,15
2019-04-30,启德邮轮码头,入境,658,292,45,995
2019-04-30,启德邮轮码头,出境,868,195,41,1104
2019-04-30,港澳客轮码头,入境,9674,1874,5052,16600
2019-04-30,港澳客轮码头,出境,9539,1979,4449,15967
2019-04-30,屯门客运码头,入境,675,19,27,721
2019-04-30,屯门客运码头,出境,597,6,20,623
2019-05-01,机场,入境,35782,20271,28085,84138
2019-05-01,机场,出境,31266,20266,27935,79467
2019-05-01,高铁西九龙,入境,6887,47187,1720,55794
2019-05-01,高铁西九龙,出境,5201,21496,1604,28301
2019-05-01,红磡,入境,1683,3407,491,5581
2019-05-01,红磡,出境,1367,1542,502,3411
2019-05-01,罗湖,入境,84407,59994,1923,146324
2019-05-01,罗湖,出境,70630,53777,1884,126291
2019-05-01,落马洲支线,入境,44831,56860,979,102670
2019-05-01,落马洲支线,出境,39410,41499,678,81587
2019-05-01,港珠澳大桥,入境,16878,17781,3724,38383
2019-05-01,港珠澳大桥,出境,15229,19389,4254,38872
2019-05-01,落马洲,入境,26941,19661,1263,47865
2019-05-01,落马洲,出境,19443,10858,691,30992
2019-05-01,文锦渡,入境,1525,5089,66,6680
2019-05-01,文锦渡,出境,1351,2575,18,3944
2019-05-01,沙头角,入境,1952,2548,152,4652
2019-05-01,沙头角,出境,1735,1458,71,3264
2019-05-01,深圳湾,入境,27065,48123,2302,77490
2019-05-01,深圳湾,出境,21906,31125,1355,54386
2019-05-01,中国客运码头,入境,1871,3804,1665,7340
2019-05-01,中国客运码头,出境,1409,3009,1718,6136
2019-05-01,港口管制,入境,6,0,39,45
2019-05-01,港口管制,出境,0,0,0,0
2019-05-01,启德邮轮码头,入境,869,196,35,1100
2019-05-01,启德邮轮码头,出境,654,670,27,1351
2019-05-01,港澳客轮码头,入境,9358,2874,4473,16705
2019-05-01,港澳客轮码头,出境,6895,2642,3823,13360
2019-05-01,屯门客运码头,入境,594,37,44,675
2019-05-01,屯门客运码头,出境,532,33,28,593
2019-05-02,机场,入境,25793,18458,27307,71558
2019-05-02,机场,出境,24758,12761,24278,61797
2019-05-02,高铁西九龙,入境,4837,38710,1607,45154
2019-05-02,高铁西九龙,出境,4512,28114,1109,33735
2019-05-02,红磡,入境,1337,2389,492,4218
2019-05-02,红磡,出境,1543,2240,376,4159
2019-05-02,罗湖,入境,69115,64926,2174,136215
2019-05-02,罗湖,出境,68197,80712,2302,151211
2019-05-02,落马洲支线,入境,42030,68084,1026,111140
2019-05-02,落马洲支线,出境,41445,63463,939,105847
2019-05-02,港珠澳大桥,入境,8733,23286,2933,34952
2019-05-02,港珠澳大桥,出境,8586,28437,3153,40176
2019-05-02,落马洲,入境,21332,16720,966,39018
2019-05-02,落马洲,出境,18559,16763,932,36254
2019-05-02,文锦渡,入境,3542,5552,51,9145
2019-05-02,文锦渡,出境,3703,3583,69,7355
2019-05-02,沙头角,入境,2403,2658,118,5179
2019-05-02,沙头角,出境,2465,1946,96,4507
2019-05-02,深圳湾,入境,24279,50809,1976,77064
2019-05-02,深圳湾,出境,23619,48160,1620,73399
2019-05-02,中国客运码头,入境,1552,3873,1652,7077
2019-05-02,中国客运码头,出境,1699,4481,1910,8090
2019-05-02,港口管制,入境,1,0,52,53
2019-05-02,港口管制,出境,3,0,35,38
2019-05-02,启德邮轮码头,入境,653,670,34,1357
2019-05-02,启德邮轮码头,出境,549,687,43,1279
2019-05-02,港澳客轮码头,入境,7306,3958,4947,16211
2019-05-02,港澳客轮码头,出境,7231,4316,4689,16236
2019-05-02,屯门客运码头,入境,426,52,29,507
2019-05-02,屯门客运码头,出境,537,42,37,616
2019-05-03,机场,入境,21716,19456,27771,68943
2019-05-03,机场,出境,27917,15539,26252,69708
2019-05-03,高铁西九龙,入境,4740,35174,1793,41707
2019-05-03,高铁西九龙,出境,5741,35264,1056,42061
2019-05-03,红磡,入境,1639,2260,698,4597
2019-05-03,红磡,出境,1823,2868,372,5063
2019-05-03,罗湖,入境,69250,50563,1987,121800
2019-05-03,罗湖,出境,78735,71630,2360,152725
2019-05-03,落马洲支线,入境,41399,54949,908,97256
2019-05-03,落马洲支线,出境,46938,60150,1003,108091
2019-05-03,港珠澳大桥,入境,9021,18567,3481,31069
2019-05-03,港珠澳大桥,出境,10719,23441,3620,37780
2019-05-03,落马洲,入境,20105,11909,896,32910
2019-05-03,落马洲,出境,21927,20243,935,43105
2019-05-03,文锦渡,入境,3604,5144,35,8783
2019-05-03,文锦渡,出境,3787,3606,83,7476
2019-05-03,沙头角,入境,2515,2418,125,5058
2019-05-03,沙头角,出境,2724,1980,113,4817
2019-05-03,深圳湾,入境,24439,41360,1929,67728
2019-05-03,深圳湾,出境,28730,52698,1755,83183
2019-05-03,中国客运码头,入境,1810,3500,1804,7114
2019-05-03,中国客运码头,出境,2041,4627,2192,8860
2019-05-03,港口管制,入境,11,0,93,104
2019-05-03,港口管制,出境,2,5,21,28
2019-05-03,启德邮轮码头,入境,967,2628,271,3866
2019-05-03,启德邮轮码头,出境,2959,1379,477,4815
2019-05-03,港澳客轮码头,入境,7928,3818,5882,17628
2019-05-03,港澳客轮码头,出境,8538,3830,4880,17248
2019-05-03,屯门客运码头,入境,431,81,43,555
2019-05-03,屯门客运码头,出境,510,61,27,598
2019-05-04,机场,入境,23936,27260,25096,76292
2019-05-04,机场,出境,25189,19613,28495,73297
2019-05-04,高铁西九龙,入境,4192,18881,1319,24392
2019-05-04,高铁西九龙,出境,7542,38495,1195,47232
2019-05-04,红磡,入境,1344,1186,550,3080
2019-05-04,红磡,出境,1942,3062,430,5434
2019-05-04,罗湖,入境,74296,28924,1939,105159
2019-05-04,罗湖,出境,95441,45200,2051,142692
2019-05-04,落马洲支线,入境,40692,31577,633,72902
2019-05-04,落马洲支线,出境,53223,38681,821,92725
2019-05-04,港珠澳大桥,入境,11631,8534,4835,25000
2019-05-04,港珠澳大桥,出境,17603,12466,4663,34732
2019-05-04,落马洲,入境,21940,6855,693,29488
2019-05-04,落马洲,出境,25398,17703,975,44076
2019-05-04,文锦渡,入境,2007,3767,33,5807
2019-05-04,文锦渡,出境,2700,3360,65,6125
2019-05-04,沙头角,入境,2027,1301,79,3407
2019-05-04,沙头角,出境,2501,1699,121,4321
2019-05-04,深圳湾,入境,22743,25627,1464,49834
2019-05-04,深圳湾,出境,32048,43429,2010,77487
2019-05-04,中国客运码头,入境,1723,1683,1977,5383
2019-05-04,中国客运码头,出境,2574,2881,2170,7625
2019-05-04,港口管制,入境,0,0,43,43
2019-05-04,港口管制,出境,0,0,11,11
2019-05-04,启德邮轮码头,入境,720,371,21,1112
2019-05-04,启德邮轮码头,出境,839,173,19,1031
2019-05-04,港澳客轮码头,入境,8378,1864,6218,16460
2019-05-04,港澳客轮码头,出境,12059,1947,5189,19195
2019-05-04,屯门客运码头,入境,511,29,47,587
2019-05-04,屯门客运码头,出境,723,23,38,784
2019-05-05,机场,入境,34679,24310,23717,82706
2019-05-05,机场,出境,26117,15943,33975,76035
2019-05-05,高铁西九龙,入境,8229,11538,1304,21071
2019-05-05,高铁西九龙,出境,5337,14835,1357,21529
2019-05-05,红磡,入境,1955,1043,396,3394
2019-05-05,红磡,出境,1048,1170,356,2574
2019-05-05,罗湖,入境,94880,22753,1818,119451
2019-05-05,罗湖,出境,68572,24963,2035,95570
2019-05-05,落马洲支线,入境,48991,19687,547,69225
2019-05-05,落马洲支线,出境,38724,19611,795,59130
2019-05-05,港珠澳大桥,入境,16424,6665,3986,27075
2019-05-05,港珠澳大桥,出境,11207,8062,5010,24279
2019-05-05,落马洲,入境,27906,6069,675,34650
2019-05-05,落马洲,出境,18564,13092,1587,33243
2019-05-05,文锦渡,入境,1899,1571,124,3594
2019-05-05,文锦渡,出境,1407,1391,35,2833
2019-05-05,沙头角,入境,2523,960,73,3556
2019-05-05,沙头角,出境,1678,825,127,2630
2019-05-05,深圳湾,入境,34813,16479,1286,52578
2019-05-05,深圳湾,出境,22756,22776,2231,47763
2019-05-05,中国客运码头,入境,2273,1199,1368,4840
2019-05-05,中国客运码头,出境,1424,1402,1915,4741
2019-05-05,港口管制,入境,137,0,45,182
2019-05-05,港口管制,出境,0,0,1,1
2019-05-05,启德邮轮码头,入境,3078,1185,422,4685
2019-05-05,启德邮轮码头,出境,959,911,248,2118
2019-05-05,港澳客轮码头,入境,11381,1042,4632,17055
2019-05-05,港澳客轮码头,出境,6979,1043,5038,13060
2019-05-05,屯门客运码头,入境,684,12,24,720
2019-05-05,屯门客运码头,出境,485,25,35,545
2019-05-11,机场,入境,27788,13946,22122,63856
2019-05-11,机场,出境,48047,11291,21425,80763
2019-05-11,高铁西九龙,入境,5712,33050,1361,40123
2019-05-11,高铁西九龙,出境,22668,24011,903,47582
2019-05-11,红磡,入境,1056,2025,370,3451
2019-05-11,红磡,出境,3210,1800,242,5252
2019-05-11,罗湖,入境,80688,49995,2056,132739
2019-05-11,罗湖,出境,138792,54384,1935,195111
2019-05-11,落马洲支线,入境,45228,54593,973,100794
2019-05-11,落马洲支线,出境,72514,50181,874,123569
2019-05-11,港珠澳大桥,入境,12431,15448,6448,34327
2019-05-11,港珠澳大桥,出境,29859,19660,5789,55308
2019-05-11,落马洲,入境,24314,14386,1154,39854
2019-05-11,落马洲,出境,31585,14310,968,46863
2019-05-11,文锦渡,入境,1903,5717,65,7685
2019-05-11,文锦渡,出境,3258,3303,49,6610
2019-05-11,沙头角,入境,2014,2192,167,4373
2019-05-11,沙头角,出境,3737,1521,78,5336
2019-05-11,深圳湾,入境,25817,43006,2256,71079
2019-05-11,深圳湾,出境,51941,41265,1734,94940
2019-05-11,中国客运码头,入境,1716,2153,1482,5351
2019-05-11,中国客运码头,出境,4010,2442,1316,7768
2019-05-11,港口管制,入境,2,0,51,53
2019-05-11,港口管制,出境,243,0,40,283
2019-05-11,启德邮轮码头,入境,625,209,28,862
2019-05-11,启德邮轮码头,出境,788,299,21,1108
2019-05-11,港澳客轮码头,入境,9128,1602,4963,15693
2019-05-11,港澳客轮码头,出境,14803,1637,4051,20491
2019-05-11,屯门客运码头,入境,496,9,46,551
2019-05-11,屯门客运码头,出境,877,24,17,918
2019-05-12,机场,入境,33832,12382,19602,65816
2019-05-12,机场,出境,37741,15363,26262,79366
2019-05-12,高铁西九龙,入境,8428,18914,1048,28390
2019-05-12,高铁西九龙,出境,12988,27043,1470,41501
2019-05-12,红磡,入境,1663,885,262,2810
2019-05-12,红磡,出境,1896,1830,349,4075
2019-05-12,罗湖,入境,104208,32653,1744,138605
2019-05-12,罗湖,出境,113972,43301,2170,159443
2019-05-12,落马洲支线,入境,58086,39080,651,97817
2019-05-12,落马洲支线,出境,69684,38986,869,109539
2019-05-12,港珠澳大桥,入境,23318,12004,5273,40595
2019-05-12,港珠澳大桥,出境,35740,17541,6404,59685
2019-05-12,落马洲,入境,31503,12733,690,44926
2019-05-12,落马洲,出境,26409,13636,1291,41336
2019-05-12,文锦渡,入境,1853,3520,76,5449
2019-05-12,文锦渡,出境,1837,2380,42,4259
2019-05-12,沙头角,入境,2511,1398,89,3998
2019-05-12,沙头角,出境,3070,1441,164,4675
2019-05-12,深圳湾,入境,39253,26712,1447,67412
2019-05-12,深圳湾,出境,46049,32700,2355,81104
2019-05-12,中国客运码头,入境,2605,1508,1179,5292
2019-05-12,中国客运码头,出境,4249,2114,1638,8001
2019-05-12,港口管制,入境,1,1,73,75
2019-05-12,港口管制,出境,1,3,32,36
2019-05-12,启德邮轮码头,入境,788,299,16,1103
2019-05-12,启德邮轮码头,出境,606,423,19,1048
2019-05-12,港澳客轮码头,入境,12837,1405,3693,17935
2019-05-12,港澳客轮码头,出境,17411,1367,4235,23013
2019-05-12,屯门客运码头,入境,706,20,33,759
2019-05-12,屯门客运码头,出境,1345,22,47,1414
2019-05-13,机场,入境,57982,11824,19576,89382
2019-05-13,机场,出境,34117,12504,21855,68476
2019-05-13,高铁西九龙,入境,26014,12578,904,39496
2019-05-13,高铁西九龙,出境,7068,11259,1023,19350
2019-05-13,红磡,入境,3946,1269,221,5436
2019-05-13,红磡,出境,1567,906,266,2739
2019-05-13,罗湖,入境,164915,24930,1539,191384
2019-05-13,罗湖,出境,92409,23377,1595,117381
2019-05-13,落马洲支线,入境,89393,20282,580,110255
2019-05-13,落马洲支线,出境,58472,15957,594,75023
2019-05-13,港珠澳大桥,入境,45565,9184,4580,59329
2019-05-13,港珠澳大桥,出境,19675,16100,5500,41275
2019-05-13,落马洲,入境,41186,10190,669,52045
2019-05-13,落马洲,出境,23582,6896,1651,32129
2019-05-13,文锦渡,入境,2821,2341,41,5203
2019-05-13,文锦渡,出境,1513,1219,30,2762
2019-05-13,沙头角,入境,4132,983,64,5179
2019-05-13,沙头角,出境,2343,706,190,3239
2019-05-13,深圳湾,入境,71230,17434,1196,89860
2019-05-13,深圳湾,出境,30648,16250,2102,49000
2019-05-13,中国客运码头,入境,5928,1243,835,8006
2019-05-13,中国客运码头,出境,2301,1383,1296,4980
2019-05-13,港口管制,入境,1,0,50,51
2019-05-13,港口管制,出境,0,0,0,0
2019-05-13,启德邮轮码头,入境,2883,735,271,3889
2019-05-13,启德邮轮码头,出境,1141,339,94,1574
2019-05-13,港澳客轮码头,入境,20573,1258,3036,24867
2019-05-13,港澳客轮码头,出境,9064,1193,3568,13825
2019-05-13,屯门客运码头,入境,1691,19,18,1728
2019-05-13,屯门客运码头,出境,768,18,38,824
2019-06-07,机场,入境,29192,16494,27712,73398
2019-06-07,机场,出境,44046,10497,21641,76184
2019-06-07,高铁西九龙,入境,6296,34660,1988,42944
2019-06-07,高铁西九龙,出境,17585,18839,1135,37559
2019-06-07,红磡,入境,1096,2152,423,3671
2019-06-07,红磡,出境,3073,1004,247,4324
2019-06-07,罗湖,入境,88261,40486,1994,130741
2019-06-07,罗湖,出境,112966,39297,2226,154489
2019-06-07,落马洲支线,入境,49950,40601,972,91523
2019-06-07,落马洲支线,出境,66871,32579,750,100200
2019-06-07,港珠澳大桥,入境,18916,10580,6677,36173
2019-06-07,港珠澳大桥,出境,28581,11990,5788,46359
2019-06-07,落马洲,入境,28208,10681,1261,40150
2019-06-07,落马洲,出境,28171,8303,837,37311
2019-06-07,文锦渡,入境,1344,3420,156,4920
2019-06-07,文锦渡,出境,1977,2003,153,4133
2019-06-07,沙头角,入境,1929,1590,170,3689
2019-06-07,沙头角,出境,3018,1061,71,4150
2019-06-07,深圳湾,入境,28622,33683,2212,64517
2019-06-07,深圳湾,出境,46100,26397,1566,74063
2019-06-07,中国客运码头,入境,1964,2346,2029,6339
2019-06-07,中国客运码头,出境,3618,2100,1714,7432
2019-06-07,港口管制,入境,1,0,81,82
2019-06-07,港口管制,出境,0,0,7,7
2019-06-07,启德邮轮码头,入境,1317,1941,1107,4365
2019-06-07,启德邮轮码头,出境,2460,1584,928,4972
2019-06-07,港澳客轮码头,入境,11721,2052,5894,19667
2019-06-07,港澳客轮码头,出境,12697,1663,4586,18946
2019-06-07,屯门客运码头,入境,776,24,75,875
2019-06-07,屯门客运码头,出境,838,22,34,894
2019-06-08,机场,入境,36398,12210,22462,71070
2019-06-08,机场,出境,30589,11664,25156,67409
2019-06-08,高铁西九龙,入境,7510,30014,1335,38859
2019-06-08,高铁西九龙,出境,7969,27914,1358,37241
2019-06-08,红磡,入境,1624,1454,314,3392
2019-06-08,红磡,出境,1514,1874,363,3751
2019-06-08,罗湖,入境,89501,44205,1939,135645
2019-06-08,罗湖,出境,94873,54844,2232,151949
2019-06-08,落马洲支线,入境,48825,50451,895,100171
2019-06-08,落马洲支线,出境,53207,50221,992,104420
2019-06-08,港珠澳大桥,入境,18264,12678,5466,36408
2019-06-08,港珠澳大桥,出境,18536,15056,5495,39087
2019-06-08,落马洲,入境,26913,10124,823,37860
2019-06-08,落马洲,出境,24449,12253,933,37635
2019-06-08,文锦渡,入境,1637,4174,157,5968
2019-06-08,文锦渡,出境,2052,3077,32,5161
2019-06-08,沙头角,入境,2028,1754,102,3884
2019-06-08,沙头角,出境,2165,1494,111,3770
2019-06-08,深圳湾,入境,29193,37573,1534,68300
2019-06-08,深圳湾,出境,30071,41554,1734,73359
2019-06-08,中国客运码头,入境,2064,2301,1591,5956
2019-06-08,中国客运码头,出境,2206,3055,1825,7086
2019-06-08,港口管制,入境,1,0,73,74
2019-06-08,港口管制,出境,1,0,6,7
2019-06-08,启德邮轮码头,入境,745,1569,128,2442
2019-06-08,启德邮轮码头,出境,889,1605,119,2613
2019-06-08,港澳客轮码头,入境,11788,2338,5827,19953
2019-06-08,港澳客轮码头,出境,11781,2377,5198,19356
2019-06-08,屯门客运码头,入境,700,35,88,823
2019-06-08,屯门客运码头,出境,709,93,43,845
2019-06-09,机场,入境,56811,14388,20219,91418
2019-06-09,机场,出境,30351,16966,34586,81903
2019-06-09,高铁西九龙,入境,18151,12846,997,31994
2019-06-09,高铁西九龙,出境,5384,26734,1726,33844
2019-06-09,红磡,入境,4334,937,219,5490
2019-06-09,红磡,出境,1189,2663,482,4334
2019-06-09,罗湖,入境,133493,26168,1603,161264
2019-06-09,罗湖,出境,71579,36551,1964,110094
2019-06-09,落马洲支线,入境,61414,27217,624,89255
2019-06-09,落马洲支线,出境,38295,30058,921,69274
2019-06-09,港珠澳大桥,入境,30091,8834,4610,43535
2019-06-09,港珠澳大桥,出境,15058,10649,5850,31557
2019-06-09,落马洲,入境,35606,7872,654,44132
2019-06-09,落马洲,出境,18553,11066,1335,30954
2019-06-09,文锦渡,入境,2214,2542,142,4898
2019-06-09,文锦渡,出境,1257,2382,23,3662
2019-06-09,沙头角,入境,3708,1106,60,4874
2019-06-09,沙头角,出境,1639,1205,170,3014
2019-06-09,深圳湾,入境,57738,21928,1438,81104
2019-06-09,深圳湾,出境,24236,31655,2386,58277
2019-06-09,中国客运码头,入境,4488,1359,1123,6970
2019-06-09,中国客运码头,出境,1641,2270,1756,5667
2019-06-09,港口管制,入境,1,0,115,116
2019-06-09,港口管制,出境,1,0,10,11
2019-06-09,启德邮轮码头,入境,2610,1640,895,5145
2019-06-09,启德邮轮码头,出境,1160,1615,326,3101
2019-06-09,港澳客轮码头,入境,15046,1645,3689,20380
2019-06-09,港澳客轮码头,出境,8479,1542,4446,14467
2019-06-09,屯门客运码头,入境,945,26,41,1012
2019-06-09,屯门客运码头,出境,727,29,95,851
2019-06-29,机场,入境,37398,17109,23204,77711
2019-06-29,机场,出境,54954,11744,19899,86597
2019-06-29,高铁西九龙,入境,5896,24647,1307,31850
2019-06-29,高铁西九龙,出境,25129,19847,1044,46020
2019-06-29,红磡,入境,1100,1429,233,2762
2019-06-29,红磡,出境,3850,1249,186,5285
2019-06-29,罗湖,入境,79368,38601,1832,119801
2019-06-29,罗湖,出境,140956,42719,1766,185441
2019-06-29,落马洲支线,入境,44766,43073,842,88681
2019-06-29,落马洲支线,出境,75455,38917,704,115076
2019-06-29,港珠澳大桥,入境,16249,9980,5057,31286
2019-06-29,港珠澳大桥,出境,38862,11506,4748,55116
2019-06-29,落马洲,入境,23727,10811,1102,35640
2019-06-29,落马洲,出境,32631,11669,868,45168
2019-06-29,文锦渡,入境,1475,3380,63,4918
2019-06-29,文锦渡,出境,2666,2786,75,5527
2019-06-29,沙头角,入境,1749,1483,125,3357
2019-06-29,沙头角,出境,3554,1257,98,4909
2019-06-29,深圳湾,入境,23962,32500,1907,58369
2019-06-29,深圳湾,出境,52505,31922,1307,85734
2019-06-29,中国客运码头,入境,1916,1863,1235,5014
2019-06-29,中国客运码头,出境,5099,1953,1106,8158
2019-06-29,港口管制,入境,1,0,31,32
2019-06-29,港口管制,出境,1,2,39,42
2019-06-29,启德邮轮码头,入境,753,304,22,1079
2019-06-29,启德邮轮码头,出境,882,332,24,1238
2019-06-29,港澳客轮码头,入境,10151,1586,4520,16257
2019-06-29,港澳客轮码头,出境,18238,1577,3837,23652
2019-06-29,屯门客运码头,入境,641,14,63,718
2019-06-29,屯门客运码头,出境,1031,18,18,1067
2019-06-30,机场,入境,43250,15320,18794,77364
2019-06-30,机场,出境,44710,15450,24963,85123
2019-06-30,高铁西九龙,入境,9293,15836,1040,26169
2019-06-30,高铁西九龙,出境,14139,21053,1399,36591
2019-06-30,红磡,入境,1942,1004,192,3138
2019-06-30,红磡,出境,1990,1559,290,3839
2019-06-30,罗湖,入境,104519,30487,1473,136479
2019-06-30,罗湖,出境,122510,38672,1766,162948
2019-06-30,落马洲支线,入境,56305,36909,637,93851
2019-06-30,落马洲支线,出境,72234,33436,780,106450
2019-06-30,港珠澳大桥,入境,25146,8914,4251,38311
2019-06-30,港珠澳大桥,出境,40908,12381,5694,58983
2019-06-30,落马洲,入境,31086,11799,755,43640
2019-06-30,落马洲,出境,28817,11139,1128,41084
2019-06-30,文锦渡,入境,1436,3076,87,4599
2019-06-30,文锦渡,出境,1912,2158,37,4107
2019-06-30,沙头角,入境,2085,1110,83,3278
2019-06-30,沙头角,出境,3114,1140,164,4418
2019-06-30,深圳湾,入境,37002,24255,1374,62631
2019-06-30,深圳湾,出境,47803,29107,1759,78669
2019-06-30,中国客运码头,入境,2843,1210,1101,5154
2019-06-30,中国客运码头,出境,4616,2008,1361,7985
2019-06-30,港口管制,入境,1,0,98,99
2019-06-30,港口管制,出境,1,0,1,2
2019-06-30,启德邮轮码头,入境,4027,730,369,5126
2019-06-30,启德邮轮码头,出境,2913,1396,165,4474
2019-06-30,港澳客轮码头,入境,14749,1305,3044,19098
2019-06-30,港澳客轮码头,出境,18677,1500,3964,24141
2019-06-30,屯门客运码头,入境,940,26,18,984
2019-06-30,屯门客运码头,出境,1382,18,34,1434
2019-07-01,机场,入境,59866,12074,16728,88668
2019-07-01,机场,出境,37017,11836,22266,71119
2019-07-01,高铁西九龙,入境,27103,10817,870,38790
2019-07-01,高铁西九龙,出境,6065,9425,786,16276
2019-07-01,红磡,入境,4419,741,173,5333
2019-07-01,红磡,出境,1033,607,180,1820
2019-07-01,罗湖,入境,162571,22043,1562,186176
2019-07-01,罗湖,出境,75924,20236,1397,97557
2019-07-01,落马洲支线,入境,89138,18069,592,107799
2019-07-01,落马洲支线,出境,45686,13617,528,59831
2019-07-01,港珠澳大桥,入境,50790,7190,3059,61039
2019-07-01,港珠澳大桥,出境,15679,17404,3115,36198
2019-07-01,落马洲,入境,43738,7718,735,52191
2019-07-01,落马洲,出境,19583,6091,974,26648
2019-07-01,文锦渡,入境,2452,1712,25,4189
2019-07-01,文锦渡,出境,1299,1158,41,2498
2019-07-01,沙头角,入境,4276,817,102,5195
2019-07-01,沙头角,出境,1948,626,101,2675
2019-07-01,深圳湾,入境,74568,13825,1327,89720
2019-07-01,深圳湾,出境,24419,12909,1657,38985
2019-07-01,中国客运码头,入境,6540,884,643,8067
2019-07-01,中国客运码头,出境,2099,1383,1166,4648
2019-07-01,港口管制,入境,34,2,52,88
2019-07-01,港口管制,出境,0,0,0,0
2019-07-01,启德邮轮码头,入境,892,312,23,1227
2019-07-01,启德邮轮码头,出境,752,268,23,1043
2019-07-01,港澳客轮码头,入境,23564,1346,2430,27340
2019-07-01,港澳客轮码头,出境,7348,1090,2423,10861
2019-07-01,屯门客运码头,入境,1757,15,14,1786
2019-07-01,屯门客运码头,出境,709,11,28,748
2019-09-12,机场,入境,30117,7169,15287,52573
2019-09-12,机场,出境,31514,7130,13718,52362
2019-09-12,高铁西九龙,入境,7361,6441,1131,14933
2019-09-12,高铁西九龙,出境,10195,6220,554,16969
2019-09-12,红磡,入境,2244,622,257,3123
2019-09-12,红磡,出境,1564,798,126,2488
2019-09-12,罗湖,入境,74067,18763,1210,94040
2019-09-12,罗湖,出境,88787,20792,946,110525
2019-09-12,落马洲支线,入境,47575,16520,669,64764
2019-09-12,落马洲支线,出境,46598,14636,381,61615
2019-09-12,港珠澳大桥,入境,9900,1941,1711,13552
2019-09-12,港珠澳大桥,出境,11652,2516,2306,16474
2019-09-12,落马洲,入境,22861,5071,1554,29486
2019-09-12,落马洲,出境,20643,5568,620,26831
2019-09-12,文锦渡,入境,3930,1317,26,5273
2019-09-12,文锦渡,出境,3998,1010,15,5023
2019-09-12,沙头角,入境,3065,741,157,3963
2019-09-12,沙头角,出境,3286,575,41,3902
2019-09-12,深圳湾,入境,30227,13261,2112,45600
2019-09-12,深圳湾,出境,33385,13932,941,48258
2019-09-12,中国客运码头,入境,2234,522,694,3450
2019-09-12,中国客运码头,出境,2127,735,638,3500
2019-09-12,港口管制,入境,13,0,48,61
2019-09-12,港口管制,出境,37,2,18,57
2019-09-12,启德邮轮码头,入境,903,120,10,1033
2019-09-12,启德邮轮码头,出境,564,72,9,645
2019-09-12,港澳客轮码头,入境,8042,473,2204,10719
2019-09-12,港澳客轮码头,出境,7936,558,2350,10844
2019-09-12,屯门客运码头,入境,542,5,19,566
2019-09-12,屯门客运码头,出境,474,2,16,492
2019-09-13,机场,入境,23125,6705,14182,44012
2019-09-13,机场,出境,35807,4900,12628,53335
2019-09-13,高铁西九龙,入境,4324,8879,1148,14351
2019-09-13,高铁西九龙,出境,17747,6076,635,24458
2019-09-13,红磡,入境,655,543,198,1396
2019-09-13,红磡,出境,2782,400,140,3322
2019-09-13,罗湖,入境,55662,19000,1270,75932
2019-09-13,罗湖,出境,114682,18488,1285,134455
2019-09-13,落马洲支线,入境,35577,19140,669,55386
2019-09-13,落马洲支线,出境,54467,16446,442,71355
2019-09-13,港珠澳大桥,入境,8726,2455,2384,13565
2019-09-13,港珠澳大桥,出境,20119,3057,2104,25280
2019-09-13,落马洲,入境,18523,5114,902,24539
2019-09-13,落马洲,出境,24953,4765,483,30201
2019-09-13,文锦渡,入境,2987,1227,19,4233
2019-09-13,文锦渡,出境,4107,938,69,5114
2019-09-13,沙头角,入境,1919,683,103,2705
2019-09-13,沙头角,出境,3911,532,42,4485
2019-09-13,深圳湾,入境,20556,15762,1850,38168
2019-09-13,深圳湾,出境,43265,13519,1074,57858
2019-09-13,中国客运码头,入境,1365,747,864,2976
2019-09-13,中国客运码头,出境,3329,697,918,4944
2019-09-13,港口管制,入境,1,0,71,72
2019-09-13,港口管制,出境,0,0,27,27
2019-09-13,启德邮轮码头,入境,1045,869,249,2163
2019-09-13,启德邮轮码头,出境,3098,1254,275,4627
2019-09-13,港澳客轮码头,入境,7501,580,2792,10873
2019-09-13,港澳客轮码头,出境,11006,599,2085,13690
2019-09-13,屯门客运码头,入境,489,3,41,533
2019-09-13,屯门客运码头,出境,541,13,12,566
2019-09-14,机场,入境,20395,4664,12938,37997
2019-09-14,机场,出境,32003,4499,11644,48146
2019-09-14,高铁西九龙,入境,6093,6659,696,13448
2019-09-14,高铁西九龙,出境,11136,6869,779,18784
2019-09-14,红磡,入境,849,449,132,1430
2019-09-14,红磡,出境,1888,424,129,2441
2019-09-14,罗湖,入境,82793,18511,1075,102379
2019-09-14,罗湖,出境,110124,22267,1259,133650
2019-09-14,落马洲支线,入境,40079,20981,457,61517
2019-09-14,落马洲支线,出境,55090,20993,507,76590
2019-09-14,港珠澳大桥,入境,18388,2944,3922,25254
2019-09-14,港珠澳大桥,出境,29495,3329,3080,35904
2019-09-14,落马洲,入境,19686,3922,382,23990
2019-09-14,落马洲,出境,25358,4722,555,30635
2019-09-14,文锦渡,入境,1371,1544,19,2934
2019-09-14,文锦渡,出境,1740,1130,100,2970
2019-09-14,沙头角,入境,2135,697,37,2869
2019-09-14,沙头角,出境,3081,589,60,3730
2019-09-14,深圳湾,入境,25073,16494,919,42486
2019-09-14,深圳湾,出境,40035,17383,1297,58715
2019-09-14,中国客运码头,入境,1971,646,886,3503
2019-09-14,中国客运码头,出境,3712,665,933,5310
2019-09-14,港口管制,入境,0,0,25,25
2019-09-14,港口管制,出境,0,0,11,11
2019-09-14,启德邮轮码头,入境,649,78,63,790
2019-09-14,启德邮轮码头,出境,956,91,5,1052
2019-09-14,港澳客轮码头,入境,9021,664,2478,12163
2019-09-14,港澳客轮码头,出境,13641,660,2207,16508
2019-09-14,屯门客运码头,入境,835,16,54,905
2019-09-14,屯门客运码头,出境,1009,17,28,1054
2019-09-15,机场,入境,37821,8445,17401,63667
2019-09-15,机场,出境,30257,7053,15846,53156
2019-09-15,高铁西九龙,入境,17025,4631,562,22218
2019-09-15,高铁西九龙,出境,5356,7468,1043,13867
2019-09-15,红磡,入境,3384,393,127,3904
2019-09-15,红磡,出境,971,694,235,1900
2019-09-15,罗湖,入境,141696,19402,1009,162107
2019-09-15,罗湖,出境,60168,21137,1301,82606
2019-09-15,落马洲支线,入境,62368,18438,383,81189
2019-09-15,落马洲支线,出境,31919,18652,637,51208
2019-09-15,港珠澳大桥,入境,33713,2627,2912,39252
2019-09-15,港珠澳大桥,出境,12222,3403,3691,19316
2019-09-15,落马洲,入境,33071,4883,454,38408
2019-09-15,落马洲,出境,15026,5068,1237,21331
2019-09-15,文锦渡,入境,2414,1389,25,3828
2019-09-15,文锦渡,出境,1135,1043,19,2197
2019-09-15,沙头角,入境,4442,687,43,5172
2019-09-15,沙头角,出境,1458,631,119,2208
2019-09-15,深圳湾,入境,63214,13675,1144,78033
2019-09-15,深圳湾,出境,19979,15990,1891,37860
2019-09-15,中国客运码头,入境,5548,573,680,6801
2019-09-15,中国客运码头,出境,1504,779,906,3189
2019-09-15,港口管制,入境,0,2,46,48
2019-09-15,港口管制,出境,2,0,1,3
2019-09-15,启德邮轮码头,入境,3406,1268,178,4852
2019-09-15,启德邮轮码头,出境,917,858,351,2126
2019-09-15,港澳客轮码头,入境,13771,535,1639,15945
2019-09-15,港澳客轮码头,出境,6845,435,1973,9253
2019-09-15,屯门客运码头,入境,1306,18,40,1364
2019-09-15,屯门客运码头,出境,523,6,52,581
2019-09-28,机场,入境,30377,8744,10799,49920
2019-09-28,机场,出境,41178,13316,15073,69567
2019-09-28,高铁西九龙,入境,5414,8995,1177,15586
2019-09-28,高铁西九龙,出境,12377,8188,463,21028
2019-09-28,红磡,入境,853,538,222,1613
2019-09-28,红磡,出境,1669,470,82,2221
2019-09-28,罗湖,入境,71895,23988,1350,97233
2019-09-28,罗湖,出境,104733,27358,826,132917
2019-09-28,落马洲支线,入境,39403,28587,676,68666
2019-09-28,落马洲支线,出境,53245,27211,389,80845
2019-09-28,港珠澳大桥,入境,12556,2566,2871,17993
2019-09-28,港珠澳大桥,出境,22230,3724,2559,28513
2019-09-28,落马洲,入境,20611,6296,1430,28337
2019-09-28,落马洲,出境,24997,6002,428,31427
2019-09-28,文锦渡,入境,1656,2343,94,4093
2019-09-28,文锦渡,出境,2321,1613,46,3980
2019-09-28,沙头角,入境,1835,981,203,3019
2019-09-28,沙头角,出境,2773,711,43,3527
2019-09-28,深圳湾,入境,22713,22119,2733,47565
2019-09-28,深圳湾,出境,36725,20244,728,57697
2019-09-28,中国客运码头,入境,1644,693,786,3123
2019-09-28,中国客运码头,出境,3626,748,619,4993
2019-09-28,港口管制,入境,1,0,35,36
2019-09-28,港口管制,出境,2,0,29,31
2019-09-28,启德邮轮码头,入境,951,524,58,1533
2019-09-28,启德邮轮码头,出境,983,394,34,1411
2019-09-28,港澳客轮码头,入境,8497,504,2079,11080
2019-09-28,港澳客轮码头,出境,13343,554,1938,15835
2019-09-28,屯门客运码头,入境,619,10,25,654
2019-09-28,屯门客运码头,出境,880,14,19,913
2019-09-29,机场,入境,34954,7386,8907,51247
2019-09-29,机场,出境,27268,13238,16694,57200
2019-09-29,高铁西九龙,入境,9992,7110,999,18101
2019-09-29,高铁西九龙,出境,6630,4999,398,12027
2019-09-29,红磡,入境,1440,820,174,2434
2019-09-29,红磡,出境,772,360,90,1222
2019-09-29,罗湖,入境,95657,18237,1078,114972
2019-09-29,罗湖,出境,73850,18287,765,92902
2019-09-29,落马洲支线,入境,51058,16268,526,67852
2019-09-29,落马洲支线,出境,38219,13925,286,52430
2019-09-29,港珠澳大桥,入境,22483,2501,2507,27491
2019-09-29,港珠澳大桥,出境,16987,2656,2947,22590
2019-09-29,落马洲,入境,26914,6237,1387,34538
2019-09-29,落马洲,出境,17721,4519,329,22569
2019-09-29,文锦渡,入境,1825,1273,73,3171
2019-09-29,文锦渡,出境,1423,844,12,2279
2019-09-29,沙头角,入境,2864,726,137,3727
2019-09-29,沙头角,出境,2280,541,20,2841
2019-09-29,深圳湾,入境,40043,14973,2073,57089
2019-09-29,深圳湾,出境,26864,11326,598,38788
2019-09-29,中国客运码头,入境,3476,495,545,4516
2019-09-29,中国客运码头,出境,2290,649,473,3412
2019-09-29,港口管制,入境,0,0,104,104
2019-09-29,港口管制,出境,0,0,1,1
2019-09-29,启德邮轮码头,入境,3072,554,360,3986
2019-09-29,启德邮轮码头,出境,817,271,224,1312
2019-09-29,港澳客轮码头,入境,12523,461,1582,14566
2019-09-29,港澳客轮码头,出境,9423,372,1589,11384
2019-09-29,屯门客运码头,入境,995,14,22,1031
2019-09-29,屯门客运码头,出境,816,9,11,836
2019-09-30,机场,入境,36897,9642,10027,56566
2019-09-30,机场,出境,22038,23249,14243,59530
2019-09-30,高铁西九龙,入境,7970,11375,1251,20596
2019-09-30,高铁西九龙,出境,7288,5860,425,13573
2019-09-30,红磡,入境,1467,876,293,2636
2019-09-30,红磡,出境,1127,471,149,1747
2019-09-30,罗湖,入境,74161,22699,1252,98112
2019-09-30,罗湖,出境,83721,19538,776,104035
2019-09-30,落马洲支线,入境,44722,19699,662,65083
2019-09-30,落马洲支线,出境,47125,16097,339,63561
2019-09-30,港珠澳大桥,入境,14185,3721,1911,19817
2019-09-30,港珠澳大桥,出境,13936,2746,2024,18706
2019-09-30,落马洲,入境,22601,10208,1485,34294
2019-09-30,落马洲,出境,21005,5503,374,26882
2019-09-30,文锦渡,入境,3273,1789,55,5117
2019-09-30,文锦渡,出境,3649,1215,18,4882
2019-09-30,沙头角,入境,2662,961,150,3773
2019-09-30,沙头角,出境,3004,590,65,3659
2019-09-30,深圳湾,入境,28068,21174,2188,51430
2019-09-30,深圳湾,出境,28067,12279,728,41074
2019-09-30,中国客运码头,入境,2481,1032,625,4138
2019-09-30,中国客运码头,出境,2066,894,410,3370
2019-09-30,港口管制,入境,1,0,52,53
2019-09-30,港口管制,出境,1,5,34,40
2019-09-30,启德邮轮码头,入境,746,71,13,830
2019-09-30,启德邮轮码头,出境,881,57,155,1093
2019-09-30,港澳客轮码头,入境,10403,668,1862,12933
2019-09-30,港澳客轮码头,出境,10340,607,1674,12621
2019-09-30,屯门客运码头,入境,791,7,21,819
2019-09-30,屯门客运码头,出境,579,10,15,604
2019-10-01,机场,入境,43552,8315,8491,60358
2019-10-01,机场,出境,18262,25924,11451,55637
2019-10-01,高铁西九龙,入境,8901,14268,1132,24301
2019-10-01,高铁西九龙,出境,4163,4066,337,8566
2019-10-01,红磡,入境,994,792,190,1976
2019-10-01,红磡,出境,512,226,67,805
2019-10-01,罗湖,入境,58762,18018,922,77702
2019-10-01,罗湖,出境,43804,12018,516,56338
2019-10-01,落马洲支线,入境,32958,14635,523,48116
2019-10-01,落马洲支线,出境,24412,8420,212,33044
2019-10-01,港珠澳大桥,入境,15153,4659,1513,21325
2019-10-01,港珠澳大桥,出境,9617,3305,1502,14424
2019-10-01,落马洲,入境,20377,11156,1455,32988
2019-10-01,落马洲,出境,14011,4533,234,18778
2019-10-01,文锦渡,入境,1336,1319,16,2671
2019-10-01,文锦渡,出境,1020,516,5,1541
2019-10-01,沙头角,入境,1899,927,122,2948
2019-10-01,沙头角,出境,1341,331,20,1692
2019-10-01,深圳湾,入境,20016,17093,1880,38989
2019-10-01,深圳湾,出境,13196,5180,357,18733
2019-10-01,中国客运码头,入境,2581,1264,591,4436
2019-10-01,中国客运码头,出境,1089,755,479,2323
2019-10-01,港口管制,入境,0,2,52,54
2019-10-01,港口管制,出境,0,0,2,2
2019-10-01,启德邮轮码头,入境,878,57,5,940
2019-10-01,启德邮轮码头,出境,478,74,7,559
2019-10-01,港澳客轮码头,入境,7192,574,1044,8810
2019-10-01,港澳客轮码头,出境,3625,541,878,5044
2019-10-01,屯门客运码头,入境,868,18,28,914
2019-10-01,屯门客运码头,出境,419,15,15,449
2019-10-02,机场,入境,33408,9835,12548,55791
2019-10-02,机场,出境,21346,16219,10210,47775
2019-10-02,高铁西九龙,入境,8382,18996,1097,28475
2019-10-02,高铁西九龙,出境,4417,9348,545,14310
2019-10-02,红磡,入境,1056,1264,263,2583
2019-10-02,红磡,出境,810,508,129,1447
2019-10-02,罗湖,入境,68924,27063,1066,97053
2019-10-02,罗湖,出境,60010,25067,887,85964
2019-10-02,落马洲支线,入境,41903,25028,589,67520
2019-10-02,落马洲支线,出境,36506,18875,383,55764
2019-10-02,港珠澳大桥,入境,11738,6961,1932,20631
2019-10-02,港珠澳大桥,出境,9366,6846,2517,18729
2019-10-02,落马洲,入境,20013,10512,750,31275
2019-10-02,落马洲,出境,14100,5208,380,19688
2019-10-02,文锦渡,入境,3664,1765,25,5454
2019-10-02,文锦渡,出境,3553,1097,7,4657
2019-10-02,沙头角,入境,2554,1093,82,3729
2019-10-02,沙头角,出境,2349,577,40,2966
2019-10-02,深圳湾,入境,25865,26784,1531,54180
2019-10-02,深圳湾,出境,19986,17001,797,37784
2019-10-02,中国客运码头,入境,1675,1708,507,3890
2019-10-02,中国客运码头,出境,1139,1332,455,2926
2019-10-02,港口管制,入境,1,0,64,65
2019-10-02,港口管制,出境,1,0,19,20
2019-10-02,启德邮轮码头,入境,478,74,11,563
2019-10-02,启德邮轮码头,出境,744,112,11,867
2019-10-02,港澳客轮码头,入境,6972,1261,2041,10274
2019-10-02,港澳客轮码头,出境,6109,958,1802,8869
2019-10-02,屯门客运码头,入境,370,13,6,389
2019-10-02,屯门客运码头,出境,407,16,18,441
2019-10-03,机场,入境,23436,12830,15228,51494
2019-10-03,机场,出境,27518,9663,10216,47397
2019-10-03,高铁西九龙,入境,5545,15816,867,22228
2019-10-03,高铁西九龙,出境,5563,14132,898,20593
2019-10-03,红磡,入境,794,964,170,1928
2019-10-03,红磡,出境,818,1259,199,2276
2019-10-03,罗湖,入境,64032,27943,971,92946
2019-10-03,罗湖,出境,66371,30334,1174,97879
2019-10-03,落马洲支线,入境,39361,25104,534,64999
2019-10-03,落马洲支线,出境,39489,22654,623,62766
2019-10-03,港珠澳大桥,入境,9788,7646,1391,18825
2019-10-03,港珠澳大桥,出境,9868,9010,1858,20736
2019-10-03,落马洲,入境,17066,7989,494,25549
2019-10-03,落马洲,出境,15733,7485,682,23900
2019-10-03,文锦渡,入境,3694,1989,32,5715
2019-10-03,文锦渡,出境,3619,1331,19,4969
2019-10-03,沙头角,入境,2486,1024,71,3581
2019-10-03,沙头角,出境,2522,804,95,3421
2019-10-03,深圳湾,入境,23465,23155,1071,47691
2019-10-03,深圳湾,出境,23675,22479,1455,47609
2019-10-03,中国客运码头,入境,1577,1829,571,3977
2019-10-03,中国客运码头,出境,1531,2054,640,4225
2019-10-03,港口管制,入境,0,0,219,219
2019-10-03,港口管制,出境,0,0,4,4
2019-10-03,启德邮轮码头,入境,753,116,499,1368
2019-10-03,启德邮轮码头,出境,701,156,161,1018
2019-10-03,港澳客轮码头,入境,6557,1349,1850,9756
2019-10-03,港澳客轮码头,出境,6986,1271,1845,10102
2019-10-03,屯门客运码头,入境,434,9,10,453
2019-10-03,屯门客运码头,出境,524,8,8,540
2019-10-04,机场,入境,23810,16666,14272,54748
2019-10-04,机场,出境,47974,7796,10211,65981
2019-10-04,高铁西九龙,入境,4604,14112,623,19339
2019-10-04,高铁西九龙,出境,12854,16917,1114,30885
2019-10-04,红磡,入境,703,1180,154,2037
2019-10-04,红磡,出境,1951,1271,246,3468
2019-10-04,罗湖,入境,60879,27228,909,89016
2019-10-04,罗湖,出境,85453,30618,1197,117268
2019-10-04,落马洲支线,入境,38779,23642,446,62867
2019-10-04,落马洲支线,出境,48599,24114,672,73385
2019-10-04,港珠澳大桥,入境,9855,6884,1783,18522
2019-10-04,港珠澳大桥,出境,15135,9755,2045,26935
2019-10-04,落马洲,入境,20442,6470,372,27284
2019-10-04,落马洲,出境,23579,9965,965,34509
2019-10-04,文锦渡,入境,3564,2139,14,5717
2019-10-04,文锦渡,出境,3903,1553,69,5525
2019-10-04,沙头角,入境,2556,958,38,3552
2019-10-04,沙头角,出境,3240,956,89,4285
2019-10-04,深圳湾,入境,22715,21703,833,45251
2019-10-04,深圳湾,出境,34945,26553,1959,63457
2019-10-04,中国客运码头,入境,1825,1941,699,4465
2019-10-04,中国客运码头,出境,2539,2383,800,5722
2019-10-04,港口管制,入境,1,0,83,84
2019-10-04,港口管制,出境,1,0,41,42
2019-10-04,启德邮轮码头,入境,811,2201,73,3085
2019-10-04,启德邮轮码头,出境,2341,2538,873,5752
2019-10-04,港澳客轮码头,入境,6804,1312,2150,10266
2019-10-04,港澳客轮码头,出境,8460,1524,1968,11952
2019-10-04,屯门客运码头,入境,560,28,18,606
2019-10-04,屯门客运码头,出境,502,17,10,529
2019-10-05,机场,入境,24119,20943,13675,58737
2019-10-05,机场,出境,45474,8553,10611,64638
2019-10-05,高铁西九龙,入境,4268,6304,376,10948
2019-10-05,高铁西九龙,出境,23739,17435,1092,42266
2019-10-05,红磡,入境,2,0,0,2
2019-10-05,红磡,出境,0,0,0,0
2019-10-05,罗湖,入境,414,6,3,423
2019-10-05,罗湖,出境,508,22,4,534
2019-10-05,落马洲支线,入境,16081,8667,279,25027
2019-10-05,落马洲支线,出境,34622,10978,505,46105
2019-10-05,港珠澳大桥,入境,9049,3939,1788,14776
2019-10-05,港珠澳大桥,出境,25787,8584,2014,36385
2019-10-05,落马洲,入境,29629,6389,581,36599
2019-10-05,落马洲,出境,55967,19095,1709,76771
2019-10-05,文锦渡,入境,5322,2166,91,7579
2019-10-05,文锦渡,出境,9629,3236,126,12991
2019-10-05,沙头角,入境,1777,494,62,2333
2019-10-05,沙头角,出境,5323,1385,176,6884
2019-10-05,深圳湾,入境,18224,10341,620,29185
2019-10-05,深圳湾,出境,59900,27746,2574,90220
2019-10-05,中国客运码头,入境,1525,887,622,3034
2019-10-05,中国客运码头,出境,5189,2464,972,8625
2019-10-05,港口管制,入境,0,0,41,41
2019-10-05,港口管制,出境,7,1,0,8
2019-10-05,启德邮轮码头,入境,744,172,6,922
2019-10-05,启德邮轮码头,出境,803,78,2,883
2019-10-05,港澳客轮码头,入境,5023,755,1600,7378
2019-10-05,港澳客轮码头,出境,11314,1359,1823,14496
2019-10-05,屯门客运码头,入境,449,11,35,495
2019-10-05,屯门客运码头,出境,916,21,16,953
2019-10-06,机场,入境,26678,28942,13253,68873
2019-10-06,机场,出境,33739,10036,12880,56655
2019-10-06,高铁西九龙,入境,6458,2677,357,9492
2019-10-06,高铁西九龙,出境,10693,12223,1060,23976
2019-10-06,红磡,入境,368,157,77,602
2019-10-06,红磡,出境,1414,387,147,1948
2019-10-06,罗湖,入境,30751,4637,404,35792
2019-10-06,罗湖,出境,51284,7886,545,59715
2019-10-06,落马洲支线,入境,29918,8267,224,38409
2019-10-06,落马洲支线,出境,42954,11328,626,54908
2019-10-06,港珠澳大桥,入境,16665,2806,1898,21369
2019-10-06,港珠澳大桥,出境,23811,5391,2210,31412
2019-10-06,落马洲,入境,31141,3675,405,35221
2019-10-06,落马洲,出境,32722,15605,1987,50314
2019-10-06,文锦渡,入境,4493,1421,23,5937
2019-10-06,文锦渡,出境,6568,2348,81,8997
2019-10-06,沙头角,入境,2454,440,45,2939
2019-10-06,沙头角,出境,3046,997,238,4281
2019-10-06,深圳湾,入境,31129,7946,501,39576
2019-10-06,深圳湾,出境,42761,22980,3417,69158
2019-10-06,中国客运码头,入境,2536,494,504,3534
2019-10-06,中国客运码头,出境,3887,1118,895,5900
2019-10-06,港口管制,入境,0,0,71,71
2019-10-06,港口管制,出境,0,0,0,0
2019-10-06,启德邮轮码头,入境,2374,2441,117,4932
2019-10-06,启德邮轮码头,出境,1610,2129,148,3887
2019-10-06,港澳客轮码头,入境,7694,604,1238,9536
2019-10-06,港澳客轮码头,出境,10220,604,1305,12129
2019-10-06,屯门客运码头,入境,903,17,27,947
2019-10-06,屯门客运码头,出境,966,8,18,992
2019-10-07,机场,入境,46464,29626,12379,88469
2019-10-07,机场,出境,28561,8097,10192,46850
2019-10-07,高铁西九龙,入境,19922,2736,288,22946
2019-10-07,高铁西九龙,出境,5765,9487,1021,16273
2019-10-07,红磡,入境,0,0,0,0
2019-10-07,红磡,出境,0,0,0,0
2019-10-07,罗湖,入境,59819,5910,350,66079
2019-10-07,罗湖,出境,26459,6639,561,33659
2019-10-07,落马洲支线,入境,51746,9747,196,61689
2019-10-07,落马洲支线,出境,27817,10670,622,39109
2019-10-07,港珠澳大桥,入境,35099,2126,1217,38442
2019-10-07,港珠澳大桥,出境,11126,3556,2332,17014
2019-10-07,落马洲,入境,58906,4663,489,64058
2019-10-07,落马洲,出境,22568,15847,2048,40463
2019-10-07,文锦渡,入境,9265,1967,46,11278
2019-10-07,文锦渡,出境,4838,2317,120,7275
2019-10-07,沙头角,入境,5217,499,48,5764
2019-10-07,沙头角,出境,2172,858,166,3196
2019-10-07,深圳湾,入境,72603,8429,623,81655
2019-10-07,深圳湾,出境,23596,19528,2518,45642
2019-10-07,中国客运码头,入境,6412,457,460,7329
2019-10-07,中国客运码头,出境,1860,701,703,3264
2019-10-07,港口管制,入境,4,0,51,55
2019-10-07,港口管制,出境,1,0,8,9
2019-10-07,启德邮轮码头,入境,933,72,20,1025
2019-10-07,启德邮轮码头,出境,762,60,9,831
2019-10-07,港澳客轮码头,入境,12763,430,948,14141
2019-10-07,港澳客轮码头,出境,6404,384,1320,8108
2019-10-07,屯门客运码头,入境,1370,11,8,1389
2019-10-07,屯门客运码头,出境,565,5,21,591
2019-12-21,机场,入境,34643,8904,17560,61107
2019-12-21,机场,出境,71827,4102,11322,87251
2019-12-21,高铁西九龙,入境,6682,10099,780,17561
2019-12-21,高铁西九龙,出境,23786,10473,712,34971
2019-12-21,红磡,入境,780,504,106,1390
2019-12-21,红磡,出境,1920,539,95,2554
2019-12-21,罗湖,入境,71035,23848,1079,95962
2019-12-21,罗湖,出境,113282,26904,1105,141291
2019-12-21,落马洲支线,入境,37999,26556,563,65118
2019-12-21,落马洲支线,出境,56598,26377,498,83473
2019-12-21,港珠澳大桥,入境,11033,2312,2995,16340
2019-12-21,港珠澳大桥,出境,19361,4052,3567,26980
2019-12-21,落马洲,入境,22304,5833,855,28992
2019-12-21,落马洲,出境,27253,6852,622,34727
2019-12-21,文锦渡,入境,1848,2208,19,4075
2019-12-21,文锦渡,出境,2649,1676,41,4366
2019-12-21,沙头角,入境,2104,994,76,3174
2019-12-21,沙头角,出境,3564,830,60,4454
2019-12-21,深圳湾,入境,24770,20023,1472,46265
2019-12-21,深圳湾,出境,45349,21947,1210,68506
2019-12-21,中国客运码头,入境,1905,781,592,3278
2019-12-21,中国客运码头,出境,2836,957,505,4298
2019-12-21,港口管制,入境,0,6,52,58
2019-12-21,港口管制,出境,0,0,10,10
2019-12-21,启德邮轮码头,入境,450,3836,1729,6015
2019-12-21,启德邮轮码头,出境,1761,3834,2559,8154
2019-12-21,港澳客轮码头,入境,7128,535,1911,9574
2019-12-21,港澳客轮码头,出境,10445,602,2139,13186
2019-12-21,屯门客运码头,入境,430,9,54,493
2019-12-21,屯门客运码头,出境,536,9,22,567
2019-12-22,机场,入境,37576,7477,16617,61670
2019-12-22,机场,出境,60705,5050,13283,79038
2019-12-22,高铁西九龙,入境,9440,5087,635,15162
2019-12-22,高铁西九龙,出境,14174,7518,824,22516
2019-12-22,红磡,入境,1120,205,86,1411
2019-12-22,红磡,出境,1084,404,130,1618
2019-12-22,罗湖,入境,85117,14791,992,100900
2019-12-22,罗湖,出境,75786,18687,1104,95577
2019-12-22,落马洲支线,入境,43899,18625,493,63017
2019-12-22,落马洲支线,出境,42036,19497,609,62142
2019-12-22,港珠澳大桥,入境,16287,1742,3228,21257
2019-12-22,港珠澳大桥,出境,19028,3567,3896,26491
2019-12-22,落马洲,入境,25770,4771,602,31143
2019-12-22,落马洲,出境,20477,5491,817,26785
2019-12-22,文锦渡,入境,1983,1284,22,3289
2019-12-22,文锦渡,出境,1707,1014,17,2738
2019-12-22,沙头角,入境,2466,441,65,2972
2019-12-22,沙头角,出境,2193,527,104,2824
2019-12-22,深圳湾,入境,32317,11368,985,44670
2019-12-22,深圳湾,出境,33036,14605,1335,48976
2019-12-22,中国客运码头,入境,2327,390,610,3327
2019-12-22,中国客运码头,出境,2676,699,783,4158
2019-12-22,港口管制,入境,0,0,236,236
2019-12-22,港口管制,出境,1,0,29,30
2019-12-22,启德邮轮码头,入境,5183,1809,611,7603
2019-12-22,启德邮轮码头,出境,4784,480,2321,7585
2019-12-22,港澳客轮码头,入境,9396,356,1698,11450
2019-12-22,港澳客轮码头,出境,10520,402,2120,13042
2019-12-22,屯门客运码头,入境,567,12,41,620
2019-12-22,屯门客运码头,出境,880,7,42,929
2019-12-23,机场,入境,33497,7607,18021,59125
2019-12-23,机场,出境,56357,4638,13002,73997
2019-12-23,高铁西九龙,入境,10265,9172,748,20185
2019-12-23,高铁西九龙,出境,15718,8189,819,24726
2019-12-23,红磡,入境,984,586,141,1711
2019-12-23,红磡,出境,1907,481,125,2513
2019-12-23,罗湖,入境,77776,21056,1046,99878
2019-12-23,罗湖,出境,90938,21086,1262,113286
2019-12-23,落马洲支线,入境,41186,17199,485,58870
2019-12-23,落马洲支线,出境,47320,15521,567,63408
2019-12-23,港珠澳大桥,入境,15907,2760,4447,23114
2019-12-23,港珠澳大桥,出境,21581,3677,4985,30243
2019-12-23,落马洲,入境,23263,7067,557,30887
2019-12-23,落马洲,出境,22838,7262,841,30941
2019-12-23,文锦渡,入境,1967,1655,35,3657
2019-12-23,文锦渡,出境,2227,1403,22,3652
2019-12-23,沙头角,入境,2118,746,63,2927
2019-12-23,沙头角,出境,2668,571,92,3331
2019-12-23,深圳湾,入境,27281,14523,1110,42914
2019-12-23,深圳湾,出境,36560,13958,1472,51990
2019-12-23,中国客运码头,入境,2887,1088,884,4859
2019-12-23,中国客运码头,出境,3181,823,872,4876
2019-12-23,港口管制,入境,1,0,33,34
2019-12-23,港口管制,出境,1,0,22,23
2019-12-23,启德邮轮码头,入境,378,26,21,425
2019-12-23,启德邮轮码头,出境,685,50,16,751
2019-12-23,港澳客轮码头,入境,9857,608,2750,13215
2019-12-23,港澳客轮码头,出境,11425,655,2696,14776
2019-12-23,屯门客运码头,入境,841,3,45,889
2019-12-23,屯门客运码头,出境,819,6,27,852
2019-12-24,机场,入境,31465,5541,17399,54405
2019-12-24,机场,出境,61634,3685,9656,74975
2019-12-24,高铁西九龙,入境,8014,8152,597,16763
2019-12-24,高铁西九龙,出境,23669,7677,731,32077
2019-12-24,红磡,入境,825,472,115,1412
2019-12-24,红磡,出境,2090,448,126,2664
2019-12-24,罗湖,入境,67387,20568,889,88844
2019-12-24,罗湖,出境,114915,21854,1063,137832
2019-12-24,落马洲支线,入境,36892,16518,506,53916
2019-12-24,落马洲支线,出境,53395,15512,445,69352
2019-12-24,港珠澳大桥,入境,15468,2342,3526,21336
2019-12-24,港珠澳大桥,出境,28661,3340,5226,37227
2019-12-24,落马洲,入境,20887,5102,531,26520
2019-12-24,落马洲,出境,27621,6321,686,34628
2019-12-24,文锦渡,入境,1829,1692,21,3542
2019-12-24,文锦渡,出境,2360,1144,15,3519
2019-12-24,沙头角,入境,1832,639,79,2550
2019-12-24,沙头角,出境,3098,584,85,3767
2019-12-24,深圳湾,入境,23872,12925,902,37699
2019-12-24,深圳湾,出境,44284,13095,1116,58495
2019-12-24,中国客运码头,入境,2249,871,682,3802
2019-12-24,中国客运码头,出境,3712,858,625,5195
2019-12-24,港口管制,入境,2,0,40,42
2019-12-24,港口管制,出境,2,0,5,7
2019-12-24,启德邮轮码头,入境,683,50,4,737
2019-12-24,启德邮轮码头,出境,902,129,9,1040
2019-12-24,港澳客轮码头,入境,9469,523,2142,12134
2019-12-24,港澳客轮码头,出境,13243,648,2144,16035
2019-12-24,屯门客运码头,入境,677,9,24,710
2019-12-24,屯门客运码头,出境,639,11,17,667
2019-12-25,机场,入境,36967,4956,18860,60783
2019-12-25,机场,出境,58138,3320,10775,72233
2019-12-25,高铁西九龙,入境,8799,4560,519,13878
2019-12-25,高铁西九龙,出境,25300,5777,651,31728
2019-12-25,红磡,入境,800,300,69,1169
2019-12-25,红磡,出境,2442,370,100,2912
2019-12-25,罗湖,入境,86038,15714,758,102510
2019-12-25,罗湖,出境,127625,18443,978,147046
2019-12-25,落马洲支线,入境,47218,13181,356,60755
2019-12-25,落马洲支线,出境,71808,12867,394,85069
2019-12-25,港珠澳大桥,入境,26409,2046,2792,31247
2019-12-25,港珠澳大桥,出境,49763,3351,6794,59908
2019-12-25,落马洲,入境,25269,4067,473,29809
2019-12-25,落马洲,出境,29031,4960,602,34593
2019-12-25,文锦渡,入境,1629,1351,37,3017
2019-12-25,文锦渡,出境,2365,861,27,3253
2019-12-25,沙头角,入境,2030,405,50,2485
2019-12-25,沙头角,出境,3606,373,73,4052
2019-12-25,深圳湾,入境,31012,8648,829,40489
2019-12-25,深圳湾,出境,59558,10070,1025,70653
2019-12-25,中国客运码头,入境,2350,466,534,3350
2019-12-25,中国客运码头,出境,5931,672,615,7218
2019-12-25,港口管制,入境,1,0,21,22
2019-12-25,港口管制,出境,0,0,0,0
2019-12-25,启德邮轮码头,入境,909,129,2404,3442
2019-12-25,启德邮轮码头,出境,877,116,13,1006
2019-12-25,港澳客轮码头,入境,10364,467,1531,12362
2019-12-25,港澳客轮码头,出境,16498,507,1940,18945
2019-12-25,屯门客运码头,入境,827,5,11,843
2019-12-25,屯门客运码头,出境,1135,10,41,1186
2019-12-26,机场,入境,47191,4930,18714,70835
2019-12-26,机场,出境,44335,3702,15898,63935
2019-12-26,高铁西九龙,入境,20703,5179,558,26440
2019-12-26,高铁西九龙,出境,12172,4967,706,17845
2019-12-26,红磡,入境,2123,424,99,2646
2019-12-26,红磡,出境,1212,352,78,1642
2019-12-26,罗湖,入境,127800,15591,942,144333
2019-12-26,罗湖,出境,74553,16564,958,92075
2019-12-26,落马洲支线,入境,63499,12940,367,76806
2019-12-26,落马洲支线,出境,41502,12009,306,53817
2019-12-26,港珠澳大桥,入境,44041,2555,3033,49629
2019-12-26,港珠澳大桥,出境,24603,3303,4483,32389
2019-12-26,落马洲,入境,33190,4136,664,37990
2019-12-26,落马洲,出境,19241,3904,559,23704
2019-12-26,文锦渡,入境,2232,1350,31,3613
2019-12-26,文锦渡,出境,1588,873,14,2475
2019-12-26,沙头角,入境,3462,529,63,4054
2019-12-26,沙头角,出境,2089,423,63,2575
2019-12-26,深圳湾,入境,60585,9914,896,71395
2019-12-26,深圳湾,出境,28698,9537,775,39010
2019-12-26,中国客运码头,入境,5799,522,650,6971
2019-12-26,中国客运码头,出境,3193,705,961,4859
2019-12-26,港口管制,入境,0,0,38,38
2019-12-26,港口管制,出境,0,0,1,1
2019-12-26,启德邮轮码头,入境,2306,116,35,2457
2019-12-26,启德邮轮码头,出境,721,97,43,861
2019-12-26,港澳客轮码头,入境,17409,479,1761,19649
2019-12-26,港澳客轮码头,出境,10869,512,2194,13575
2019-12-26,屯门客运码头,入境,1328,14,18,1360
2019-12-26,屯门客运码头,出境,796,7,20,823
2019-12-27,机场,入境,45092,5647,18949,69688
2019-12-27,机场,出境,49396,4516,14751,68663
2019-12-27,高铁西九龙,入境,14835,8725,841,24401
2019-12-27,高铁西九龙,出境,12321,7451,750,20522
2019-12-27,红磡,入境,1542,543,146,2231
2019-12-27,红磡,出境,1649,489,118,2256
2019-12-27,罗湖,入境,85184,21214,1186,107584
2019-12-27,罗湖,出境,79766,21496,1134,102396
2019-12-27,落马洲支线,入境,46481,17890,568,64939
2019-12-27,落马洲支线,出境,41750,15756,445,57951
2019-12-27,港珠澳大桥,入境,24533,2497,3201,30231
2019-12-27,港珠澳大桥,出境,20652,4257,4372,29281
2019-12-27,落马洲,入境,26181,6465,901,33547
2019-12-27,落马洲,出境,20659,5319,617,26595
2019-12-27,文锦渡,入境,2263,1678,21,3962
2019-12-27,文锦渡,出境,1981,1122,25,3128
2019-12-27,沙头角,入境,2487,674,103,3264
2019-12-27,沙头角,出境,2174,548,59,2781
2019-12-27,深圳湾,入境,35323,14629,1374,51326
2019-12-27,深圳湾,出境,30441,13317,1027,44785
2019-12-27,中国客运码头,入境,3946,849,1033,5828
2019-12-27,中国客运码头,出境,2715,876,955,4546
2019-12-27,港口管制,入境,0,0,227,227
2019-12-27,港口管制,出境,6,0,15,21
2019-12-27,启德邮轮码头,入境,2386,313,171,2870
2019-12-27,启德邮轮码头,出境,3367,360,3102,6829
2019-12-27,港澳客轮码头,入境,13405,621,2919,16945
2019-12-27,港澳客轮码头,出境,11577,629,2886,15092
2019-12-27,屯门客运码头,入境,902,10,25,937
2019-12-27,屯门客运码头,出境,756,5,26,787
2019-12-28,机场,入境,52705,5088,20784,78577
2019-12-28,机场,出境,39197,5306,15715,60218
2019-12-28,高铁西九龙,入境,14703,9205,897,24805
2019-12-28,高铁西九龙,出境,11581,8326,733,20640
2019-12-28,红磡,入境,1355,377,128,1860
2019-12-28,红磡,出境,1306,382,106,1794
2019-12-28,罗湖,入境,78697,22234,1356,102287
2019-12-28,罗湖,出境,93192,24405,1087,118684
2019-12-28,落马洲支线,入境,44287,27320,516,72123
2019-12-28,落马洲支线,出境,49172,26015,444,75631
2019-12-28,港珠澳大桥,入境,23282,2729,3736,29747
2019-12-28,港珠澳大桥,出境,23640,4086,4911,32637
2019-12-28,落马洲,入境,23586,6926,847,31359
2019-12-28,落马洲,出境,22954,5235,581,28770
2019-12-28,文锦渡,入境,1984,2189,12,4185
2019-12-28,文锦渡,出境,2097,1643,35,3775
2019-12-28,沙头角,入境,2131,750,76,2957
2019-12-28,沙头角,出境,2372,635,38,3045
2019-12-28,深圳湾,入境,32617,20750,1308,54675
2019-12-28,深圳湾,出境,35882,19865,1069,56816
2019-12-28,中国客运码头,入境,3295,763,1157,5215
2019-12-28,中国客运码头,出境,3145,747,949,4841
2019-12-28,港口管制,入境,0,0,44,44
2019-12-28,港口管制,出境,0,0,16,16
2019-12-28,启德邮轮码头,入境,214,4118,52,4384
2019-12-28,启德邮轮码头,出境,212,4115,54,4381
2019-12-28,港澳客轮码头,入境,11983,469,3065,15517
2019-12-28,港澳客轮码头,出境,12632,578,2740,15950
2019-12-28,屯门客运码头,入境,753,16,35,804
2019-12-28,屯门客运码头,出境,709,10,30,749
2019-12-29,机场,入境,68857,4043,15071,87971
2019-12-29,机场,出境,34214,5197,18618,58029
2019-12-29,高铁西九龙,入境,21898,6316,807,29021
2019-12-29,高铁西九龙,出境,7820,7210,714,15744
2019-12-29,红磡,入境,2361,270,126,2757
2019-12-29,红磡,出境,909,565,130,1604
2019-12-29,罗湖,入境,105272,17421,1284,123977
2019-12-29,罗湖,出境,68849,20296,1133,90278
2019-12-29,落马洲支线,入境,52506,21017,465,73988
2019-12-29,落马洲支线,出境,36680,21319,420,58419
2019-12-29,港珠澳大桥,入境,28882,2493,3261,34636
2019-12-29,港珠澳大桥,出境,18039,5016,4424,27479
2019-12-29,落马洲,入境,28831,5042,705,34578
2019-12-29,落马洲,出境,17354,4405,471,22230
2019-12-29,文锦渡,入境,2185,1533,24,3742
2019-12-29,文锦渡,出境,1325,1004,22,2351
2019-12-29,沙头角,入境,2883,562,75,3520
2019-12-29,沙头角,出境,1713,567,48,2328
2019-12-29,深圳湾,入境,52401,14520,1147,68068
2019-12-29,深圳湾,出境,27509,16198,846,44553
2019-12-29,中国客运码头,入境,3841,557,986,5384
2019-12-29,中国客运码头,出境,1933,703,1116,3752
2019-12-29,港口管制,入境,0,0,205,205
2019-12-29,港口管制,出境,0,0,1,1
2019-12-29,启德邮轮码头,入境,5895,628,2230,8753
2019-12-29,启德邮轮码头,出境,3296,706,2560,6562
2019-12-29,港澳客轮码头,入境,13038,440,2626,16104
2019-12-29,港澳客轮码头,出境,9147,416,2774,12337
2019-12-29,屯门客运码头,入境,837,9,25,871
2019-12-29,屯门客运码头,出境,587,0,24,611
2019-12-30,机场,入境,58966,4999,18078,82043
2019-12-30,机场,出境,27989,4963,17085,50037
2019-12-30,高铁西九龙,入境,15359,8155,1052,24566
2019-12-30,高铁西九龙,出境,8018,7427,730,16175
2019-12-30,红磡,入境,1426,490,178,2094
2019-12-30,红磡,出境,1281,512,113,1906
2019-12-30,罗湖,入境,86161,19281,1275,106717
2019-12-30,罗湖,出境,76290,19184,1191,96665
2019-12-30,落马洲支线,入境,44897,16618,483,61998
2019-12-30,落马洲支线,出境,39914,14679,475,55068
2019-12-30,港珠澳大桥,入境,18713,2268,3760,24741
2019-12-30,港珠澳大桥,出境,15315,3596,4501,23412
2019-12-30,落马洲,入境,25832,8104,599,34535
2019-12-30,落马洲,出境,20952,5759,524,27235
2019-12-30,文锦渡,入境,2256,1712,12,3980
2019-12-30,文锦渡,出境,1867,1061,12,2940
2019-12-30,沙头角,入境,2373,653,66,3092
2019-12-30,沙头角,出境,2283,521,69,2873
2019-12-30,深圳湾,入境,36863,13269,1294,51426
2019-12-30,深圳湾,出境,26718,12663,1011,40392
2019-12-30,中国客运码头,入境,3032,977,1338,5347
2019-12-30,中国客运码头,出境,2359,902,1093,4354
2019-12-30,港口管制,入境,0,0,40,40
2019-12-30,港口管制,出境,1,0,1,2
2019-12-30,启德邮轮码头,入境,555,57,2867,3479
2019-12-30,启德邮轮码头,出境,486,59,26,571
2019-12-30,港澳客轮码头,入境,10498,567,3302,14367
2019-12-30,港澳客轮码头,出境,9942,543,2983,13468
2019-12-30,屯门客运码头,入境,626,5,30,661
2019-12-30,屯门客运码头,出境,601,4,23,628
2019-12-31,机场,入境,58757,4109,14087,76953
2019-12-31,机场,出境,26654,5183,14984,46821
2019-12-31,高铁西九龙,入境,13602,7453,1188,22243
2019-12-31,高铁西九龙,出境,9502,6318,502,16322
2019-12-31,红磡,入境,1528,467,162,2157
2019-12-31,红磡,出境,1026,420,115,1561
2019-12-31,罗湖,入境,79480,19271,1102,99853
2019-12-31,罗湖,出境,86505,19042,816,106363
2019-12-31,落马洲支线,入境,43113,16921,494,60528
2019-12-31,落马洲支线,出境,45852,14823,331,61006
2019-12-31,港珠澳大桥,入境,15091,2265,2835,20191
2019-12-31,港珠澳大桥,出境,16844,3196,3347,23387
2019-12-31,落马洲,入境,22789,5464,724,28977
2019-12-31,落马洲,出境,24429,4928,410,29767
2019-12-31,文锦渡,入境,2075,1388,27,3490
2019-12-31,文锦渡,出境,2063,973,14,3050
2019-12-31,沙头角,入境,2426,652,102,3180
2019-12-31,沙头角,出境,2196,505,48,2749
2019-12-31,深圳湾,入境,34406,13059,1128,48593
2019-12-31,深圳湾,出境,27484,11880,776,40140
2019-12-31,中国客运码头,入境,2507,649,889,4045
2019-12-31,中国客运码头,出境,2055,767,780,3602
2019-12-31,港口管制,入境,31,0,63,94
2019-12-31,港口管制,出境,0,0,3,3
2019-12-31,启德邮轮码头,入境,482,55,1559,2096
2019-12-31,启德邮轮码头,出境,1101,94,2850,4045
2019-12-31,港澳客轮码头,入境,8645,480,2471,11596
2019-12-31,港澳客轮码头,出境,10108,567,2221,12896
2019-12-31,屯门客运码头,入境,536,7,27,570
2019-12-31,屯门客运码头,出境,558,5,14,577
2020-01-01,机场,入境,66624,3733,11409,81766
2020-01-01,机场,出境,28618,4677,19370,52665
2020-01-01,高铁西九龙,入境,15040,6781,558,22379
2020-01-01,高铁西九龙,出境,5699,7106,917,13722
2020-01-01,红磡,入境,1262,272,82,1616
2020-01-01,红磡,出境,521,312,127,960
2020-01-01,罗湖,入境,89085,18772,820,108677
2020-01-01,罗湖,出境,60030,20727,906,81663
2020-01-01,落马洲支线,入境,47703,20848,386,68937
2020-01-01,落马洲支线,出境,33278,19336,488,53102
2020-01-01,港珠澳大桥,入境,22679,2560,3541,28780
2020-01-01,港珠澳大桥,出境,13922,4611,3923,22456
2020-01-01,落马洲,入境,28570,4410,465,33445
2020-01-01,落马洲,出境,16541,4677,614,21832
2020-01-01,文锦渡,入境,1937,1335,15,3287
2020-01-01,文锦渡,出境,1373,916,6,2295
2020-01-01,沙头角,入境,2285,543,51,2879
2020-01-01,沙头角,出境,1413,471,63,1947
2020-01-01,深圳湾,入境,38549,13755,848,53152
2020-01-01,深圳湾,出境,21240,13247,1000,35487
2020-01-01,中国客运码头,入境,2556,421,737,3714
2020-01-01,中国客运码头,出境,1242,566,923,2731
2020-01-01,港口管制,入境,1,0,24,25
2020-01-01,港口管制,出境,0,0,14,14
2020-01-01,启德邮轮码头,入境,1081,79,16,1176
2020-01-01,启德邮轮码头,出境,476,77,26,579
2020-01-01,港澳客轮码头,入境,8883,505,1904,11292
2020-01-01,港澳客轮码头,出境,5755,414,2015,8184
2020-01-01,屯门客运码头,入境,686,10,23,719
2020-01-01,屯门客运码头,出境,436,5,19,460
2020-01-24,机场,入境,20724,9124,14116,43964
2020-01-24,机场,出境,74876,4451,7242,86569
2020-01-24,高铁西九龙,入境,1717,2380,337,4434
2020-01-24,高铁西九龙,出境,20096,2800,316,23212
2020-01-24,红磡,入境,433,470,71,974
2020-01-24,红磡,出境,3498,194,51,3743
2020-01-24,罗湖,入境,26340,7383,429,34152
2020-01-24,罗湖,出境,72074,6231,413,78718
2020-01-24,落马洲支线,入境,16750,4979,196,21925
2020-01-24,落马洲支线,出境,32215,3766,167,36148
2020-01-24,港珠澳大桥,入境,7294,1949,2130,11373
2020-01-24,港珠澳大桥,出境,15775,2804,2086,20665
2020-01-24,落马洲,入境,10591,2921,407,13919
2020-01-24,落马洲,出境,17682,3901,283,21866
2020-01-24,文锦渡,入境,1093,367,9,1469
2020-01-24,文锦渡,出境,1890,219,9,2118
2020-01-24,沙头角,入境,1008,264,27,1299
2020-01-24,沙头角,出境,3207,210,40,3457
2020-01-24,深圳湾,入境,8792,5354,685,14831
2020-01-24,深圳湾,出境,37864,5142,484,43490
2020-01-24,中国客运码头,入境,1013,442,373,1828
2020-01-24,中国客运码头,出境,3511,453,312,4276
2020-01-24,港口管制,入境,7,0,259,266
2020-01-24,港口管制,出境,77,0,4,81
2020-01-24,启德邮轮码头,入境,466,707,2400,3573
2020-01-24,启德邮轮码头,出境,2487,775,280,3542
2020-01-24,港澳客轮码头,入境,6001,358,1395,7754
2020-01-24,港澳客轮码头,出境,8985,390,1314,10689
2020-01-24,屯门客运码头,入境,434,7,38,479
2020-01-24,屯门客运码头,出境,548,4,17,569
2020-01-25,机场,入境,14907,8489,10953,34349
2020-01-25,机场,出境,58711,5326,7335,71372
2020-01-25,高铁西九龙,入境,1852,2278,285,4415
2020-01-25,高铁西九龙,出境,8489,2089,224,10802
2020-01-25,红磡,入境,575,176,67,818
2020-01-25,红磡,出境,1509,153,53,1715
2020-01-25,罗湖,入境,20716,4368,317,25401
2020-01-25,罗湖,出境,39692,5468,347,45507
2020-01-25,落马洲支线,入境,12511,3237,117,15865
2020-01-25,落马洲支线,出境,16675,3347,155,20177
2020-01-25,港珠澳大桥,入境,9121,2682,2339,14142
2020-01-25,港珠澳大桥,出境,13570,2949,1830,18349
2020-01-25,落马洲,入境,7187,2662,234,10083
2020-01-25,落马洲,出境,10351,3163,195,13709
2020-01-25,文锦渡,入境,753,262,12,1027
2020-01-25,文锦渡,出境,895,203,5,1103
2020-01-25,沙头角,入境,923,208,19,1150
2020-01-25,沙头角,出境,1702,165,38,1905
2020-01-25,深圳湾,入境,9834,4540,532,14906
2020-01-25,深圳湾,出境,20440,4993,451,25884
2020-01-25,中国客运码头,入境,1183,463,499,2145
2020-01-25,中国客运码头,出境,2233,406,415,3054
2020-01-25,港口管制,入境,2,0,89,91
2020-01-25,港口管制,出境,2,0,2,4
2020-01-25,启德邮轮码头,入境,168,25,2315,2508
2020-01-25,启德邮轮码头,出境,2997,129,2521,5647
2020-01-25,港澳客轮码头,入境,6118,490,1355,7963
2020-01-25,港澳客轮码头,出境,8120,378,1048,9546
2020-01-25,屯门客运码头,入境,567,11,44,622
2020-01-25,屯门客运码头,出境,782,19,14,815
2020-01-26,机场,入境,22646,10955,7522,41123
2020-01-26,机场,出境,47580,7870,8813,64263
2020-01-26,高铁西九龙,入境,7481,2481,415,10377
2020-01-26,高铁西九龙,出境,2360,2875,300,5535
2020-01-26,红磡,入境,2237,272,137,2646
2020-01-26,红磡,出境,575,307,54,936
2020-01-26,罗湖,入境,44781,4994,406,50181
2020-01-26,罗湖,出境,22105,6754,348,29207
2020-01-26,落马洲支线,入境,19606,3816,265,23687
2020-01-26,落马洲支线,出境,10678,4376,226,15280
2020-01-26,港珠澳大桥,入境,12967,2486,2311,17764
2020-01-26,港珠澳大桥,出境,10182,3053,2082,15317
2020-01-26,落马洲,入境,10754,3119,362,14235
2020-01-26,落马洲,出境,7058,3642,240,10940
2020-01-26,文锦渡,入境,1093,345,24,1462
2020-01-26,文锦渡,出境,709,324,5,1038
2020-01-26,沙头角,入境,2077,284,40,2401
2020-01-26,沙头角,出境,1058,312,48,1418
2020-01-26,深圳湾,入境,26235,6051,868,33154
2020-01-26,深圳湾,出境,9524,7404,529,17457
2020-01-26,中国客运码头,入境,2418,522,501,3441
2020-01-26,中国客运码头,出境,1391,603,504,2498
2020-01-26,港口管制,入境,0,0,256,256
2020-01-26,港口管制,出境,0,0,0,0
2020-01-26,启德邮轮码头,入境,2510,806,2251,5567
2020-01-26,启德邮轮码头,出境,1000,394,317,1711
2020-01-26,港澳客轮码头,入境,8216,554,1325,10095
2020-01-26,港澳客轮码头,出境,6571,379,1284,8234
2020-01-26,屯门客运码头,入境,647,5,24,676
2020-01-26,屯门客运码头,出境,605,7,28,640
2020-01-27,机场,入境,36215,10309,6764,53288
2020-01-27,机场,出境,41316,8203,11319,60838
2020-01-27,高铁西九龙,入境,10913,1887,421,13221
2020-01-27,高铁西九龙,出境,1167,2790,246,4203
2020-01-27,红磡,入境,2025,221,116,2362
2020-01-27,红磡,出境,244,308,54,606
2020-01-27,罗湖,入境,43145,3643,387,47175
2020-01-27,罗湖,出境,13999,5193,387,19579
2020-01-27,落马洲支线,入境,17463,2863,203,20529
2020-01-27,落马洲支线,出境,7787,3592,175,11554
2020-01-27,港珠澳大桥,入境,14306,1998,1998,18302
2020-01-27,港珠澳大桥,出境,7369,2822,2088,12279
2020-01-27,落马洲,入境,10708,1945,356,13009
2020-01-27,落马洲,出境,5174,3655,233,9062
2020-01-27,文锦渡,入境,1280,281,12,1573
2020-01-27,文锦渡,出境,569,324,5,898
2020-01-27,沙头角,入境,2212,189,36,2437
2020-01-27,沙头角,出境,617,337,81,1035
2020-01-27,深圳湾,入境,27513,4507,759,32779
2020-01-27,深圳湾,出境,5065,6538,598,12201
2020-01-27,中国客运码头,入境,3124,477,431,4032
2020-01-27,中国客运码头,出境,944,530,411,1885
2020-01-27,港口管制,入境,69,0,32,101
2020-01-27,港口管制,出境,28,0,25,53
2020-01-27,启德邮轮码头,入境,638,56,12,706
2020-01-27,启德邮轮码头,出境,706,66,2190,2962
2020-01-27,港澳客轮码头,入境,7258,394,1271,8923
2020-01-27,港澳客轮码头,出境,4981,343,1094,6418
2020-01-27,屯门客运码头,入境,601,10,18,629
2020-01-27,屯门客运码头,出境,511,2,24,537
2020-01-28,机场,入境,54491,7187,5422,67100
2020-01-28,机场,出境,41100,8306,12151,61557
2020-01-28,高铁西九龙,入境,13133,1828,322,15283
2020-01-28,高铁西九龙,出境,864,2499,212,3575
2020-01-28,红磡,入境,1754,194,64,2012
2020-01-28,红磡,出境,203,316,56,575
2020-01-28,罗湖,入境,39880,3633,381,43894
2020-01-28,罗湖,出境,12598,4654,290,17542
2020-01-28,落马洲支线,入境,17313,2575,194,20082
2020-01-28,落马洲支线,出境,7253,3018,175,10446
2020-01-28,港珠澳大桥,入境,12420,1551,1534,15505
2020-01-28,港珠澳大桥,出境,5417,1795,1625,8837
2020-01-28,落马洲,入境,10279,1831,329,12439
2020-01-28,落马洲,出境,4780,2722,202,7704
2020-01-28,文锦渡,入境,1551,283,4,1838
2020-01-28,文锦渡,出境,582,269,3,854
2020-01-28,沙头角,入境,2173,245,66,2484
2020-01-28,沙头角,出境,433,210,58,701
2020-01-28,深圳湾,入境,26094,4217,738,31049
2020-01-28,深圳湾,出境,3797,5022,513,9332
2020-01-28,中国客运码头,入境,2761,314,222,3297
2020-01-28,中国客运码头,出境,509,371,323,1203
2020-01-28,港口管制,入境,17,0,34,51
2020-01-28,港口管制,出境,1,0,12,13
2020-01-28,启德邮轮码头,入境,705,56,8,769
2020-01-28,启德邮轮码头,出境,427,75,6,508
2020-01-28,港澳客轮码头,入境,5745,238,912,6895
2020-01-28,港澳客轮码头,出境,3634,288,864,4786
2020-01-28,屯门客运码头,入境,472,4,18,494
2020-01-28,屯门客运码头,出境,306,1,27,334
2020-01-29,机场,入境,50292,9196,5871,65359
2020-01-29,机场,出境,33880,7550,10514,51944
2020-01-29,高铁西九龙,入境,20022,1817,403,22242
2020-01-29,高铁西九龙,出境,1195,3524,261,4980
2020-01-29,红磡,入境,2038,201,87,2326
2020-01-29,红磡,出境,222,462,79,763
2020-01-29,罗湖,入境,44426,4343,485,49254
2020-01-29,罗湖,出境,13519,5099,350,18968
2020-01-29,落马洲支线,入境,19574,3003,323,22900
2020-01-29,落马洲支线,出境,8304,3414,245,11963
2020-01-29,港珠澳大桥,入境,10793,1363,1168,13324
2020-01-29,港珠澳大桥,出境,4213,1588,1479,7280
2020-01-29,落马洲,入境,11236,1900,385,13521
2020-01-29,落马洲,出境,5371,3111,252,8734
2020-01-29,文锦渡,入境,1459,293,11,1763
2020-01-29,文锦渡,出境,629,308,10,947
2020-01-29,沙头角,入境,2739,320,61,3120
2020-01-29,沙头角,出境,517,311,87,915
2020-01-29,深圳湾,入境,26892,4695,996,32583
2020-01-29,深圳湾,出境,4398,6648,678,11724
2020-01-29,中国客运码头,入境,3138,320,271,3729
2020-01-29,中国客运码头,出境,522,497,266,1285
2020-01-29,港口管制,入境,0,0,41,41
2020-01-29,港口管制,出境,0,0,0,0
2020-01-29,启德邮轮码头,入境,427,75,10,512
2020-01-29,启德邮轮码头,出境,372,49,21,442
2020-01-29,港澳客轮码头,入境,4223,250,869,5342
2020-01-29,港澳客轮码头,出境,3211,223,877,4311
2020-01-29,屯门客运码头,入境,313,4,17,334
2020-01-29,屯门客运码头,出境,293,1,24,318
2020-01-30,机场,入境,46214,9907,5530,61651
2020-01-30,机场,出境,31072,7122,9882,48076
2020-01-30,高铁西九龙,入境,0,0,0,0
2020-01-30,高铁西九龙,出境,0,0,0,0
2020-01-30,红磡,入境,0,0,0,0
2020-01-30,红磡,出境,0,0,0,0
2020-01-30,罗湖,入境,30427,2470,308,33205
2020-01-30,罗湖,出境,13178,3893,294,17365
2020-01-30,落马洲支线,入境,15978,1711,205,17894
2020-01-30,落马洲支线,出境,8048,2570,168,10786
2020-01-30,港珠澳大桥,入境,7032,946,923,8901
2020-01-30,港珠澳大桥,出境,3554,1360,1155,6069
2020-01-30,落马洲,入境,9186,1430,312,10928
2020-01-30,落马洲,出境,4706,3386,322,8414
2020-01-30,文锦渡,入境,0,0,0,0
2020-01-30,文锦渡,出境,0,0,0,0
2020-01-30,沙头角,入境,0,0,0,0
2020-01-30,沙头角,出境,0,0,0,0
2020-01-30,深圳湾,入境,17109,2785,660,20554
2020-01-30,深圳湾,出境,3707,6196,660,10563
2020-01-30,中国客运码头,入境,0,0,0,0
2020-01-30,中国客运码头,出境,0,0,0,0
2020-01-30,港口管制,入境,1,0,69,70
2020-01-30,港口管制,出境,0,0,22,22
2020-01-30,启德邮轮码头,入境,2921,134,161,3216
2020-01-30,启德邮轮码头,出境,682,52,1761,2495
2020-01-30,港澳客轮码头,入境,3638,172,694,4504
2020-01-30,港澳客轮码头,出境,3132,249,806,4187
2020-01-30,屯门客运码头,入境,0,0,0,0
2020-01-30,屯门客运码头,出境,0,0,0,0
2020-01-31,机场,入境,49093,7817,5089,61999
2020-01-31,机场,出境,28231,5737,7599,41567
2020-01-31,高铁西九龙,入境,0,0,0,0
2020-01-31,高铁西九龙,出境,0,0,0,0
2020-01-31,红磡,入境,0,0,0,0
2020-01-31,红磡,出境,0,0,0,0
2020-01-31,罗湖,入境,24064,1960,257,26281
2020-01-31,罗湖,出境,13695,2845,267,16807
2020-01-31,落马洲支线,入境,14044,1518,181,15743
2020-01-31,落马洲支线,出境,8490,1939,163,10592
2020-01-31,港珠澳大桥,入境,5754,653,883,7290
2020-01-31,港珠澳大桥,出境,3626,897,1078,5601
2020-01-31,落马洲,入境,7807,1200,225,9232
2020-01-31,落马洲,出境,4879,2598,302,7779
2020-01-31,文锦渡,入境,0,0,0,0
2020-01-31,文锦渡,出境,0,0,0,0
2020-01-31,沙头角,入境,0,0,0,0
2020-01-31,沙头角,出境,0,0,0,0
2020-01-31,深圳湾,入境,11541,2412,567,14520
2020-01-31,深圳湾,出境,3727,4789,632,9148
2020-01-31,中国客运码头,入境,0,0,0,0
2020-01-31,中国客运码头,出境,0,0,0,0
2020-01-31,港口管制,入境,2,0,330,332
2020-01-31,港口管制,出境,2,0,9,11
2020-01-31,启德邮轮码头,入境,828,377,91,1296
2020-01-31,启德邮轮码头,出境,1603,65,242,1910
2020-01-31,港澳客轮码头,入境,3411,121,634,4166
2020-01-31,港澳客轮码头,出境,3253,124,660,4037
2020-01-31,屯门客运码头,入境,0,0,0,0
2020-01-31,屯门客运码头,出境,0,0,0,0
2020-02-01,机场,入境,55976,5703,4567,66246
2020-02-01,机场,出境,28798,5072,8046,41916
2020-02-01,高铁西九龙,入境,0,0,0,0
2020-02-01,高铁西九龙,出境,0,0,0,0
2020-02-01,红磡,入境,0,0,0,0
2020-02-01,红磡,出境,0,0,0,0
2020-02-01,罗湖,入境,21578,1883,276,23737
2020-02-01,罗湖,出境,13759,2347,234,16340
2020-02-01,落马洲支线,入境,12975,1505,165,14645
2020-02-01,落马洲支线,出境,8541,1805,139,10485
2020-02-01,港珠澳大桥,入境,4926,632,1021,6579
2020-02-01,港珠澳大桥,出境,3259,784,1339,5382
2020-02-01,落马洲,入境,6674,1134,236,8044
2020-02-01,落马洲,出境,4940,1855,179,6974
2020-02-01,文锦渡,入境,0,0,0,0
2020-02-01,文锦渡,出境,0,0,0,0
2020-02-01,沙头角,入境,0,0,0,0
2020-02-01,沙头角,出境,0,0,0,0
2020-02-01,深圳湾,入境,9788,2429,505,12722
2020-02-01,深圳湾,出境,3378,3425,499,7302
2020-02-01,中国客运码头,入境,0,0,0,0
2020-02-01,中国客运码头,出境,0,0,0,0
2020-02-01,港口管制,入境,0,0,60,60
2020-02-01,港口管制,出境,0,0,5,5
2020-02-01,启德邮轮码头,入境,25,8,2334,2367
2020-02-01,启德邮轮码头,出境,129,6,1965,2100
2020-02-01,港澳客轮码头,入境,3180,88,596,3864
2020-02-01,港澳客轮码头,出境,3043,105,550,3698
2020-02-01,屯门客运码头,入境,0,0,0,0
2020-02-01,屯门客运码头,出境,0,0,0,0
2020-02-02,机场,入境,59083,4649,3762,67494
2020-02-02,机场,出境,25570,4360,6898,36828
2020-02-02,高铁西九龙,入境,0,0,0,0
2020-02-02,高铁西九龙,出境,0,0,0,0
2020-02-02,红磡,入境,0,0,0,0
2020-02-02,红磡,出境,0,0,0,0
2020-02-02,罗湖,入境,13138,1159,190,14487
2020-02-02,罗湖,出境,6575,1392,151,8118
2020-02-02,落马洲支线,入境,17716,1739,177,19632
2020-02-02,落马洲支线,出境,9832,2902,209,12943
2020-02-02,港珠澳大桥,入境,5108,487,804,6399
2020-02-02,港珠澳大桥,出境,3165,649,1270,5084
2020-02-02,落马洲,入境,10954,1272,254,12480
2020-02-02,落马洲,出境,4362,1820,234,6416
2020-02-02,文锦渡,入境,0,0,0,0
2020-02-02,文锦渡,出境,0,0,0,0
2020-02-02,沙头角,入境,0,0,0,0
2020-02-02,沙头角,出境,0,0,0,0
2020-02-02,深圳湾,入境,11706,2253,606,14565
2020-02-02,深圳湾,出境,2968,3130,454,6552
2020-02-02,中国客运码头,入境,0,0,0,0
2020-02-02,中国客运码头,出境,0,0,0,0
2020-02-02,港口管制,入境,0,0,184,184
2020-02-02,港口管制,出境,0,0,0,0
2020-02-02,启德邮轮码头,入境,1637,58,53,1748
2020-02-02,启德邮轮码头,出境,2172,22,241,2435
2020-02-02,港澳客轮码头,入境,3057,98,369,3524
2020-02-02,港澳客轮码头,出境,2697,110,486,3293
2020-02-02,屯门客运码头,入境,0,0,0,0
2020-02-02,屯门客运码头,出境,0,0,0,0
2020-02-03,机场,入境,41208,6996,3846,52050
2020-02-03,机场,出境,21704,3596,5428,30728
2020-02-03,高铁西九龙,入境,0,0,0,0
2020-02-03,高铁西九龙,出境,0,0,0,0
2020-02-03,红磡,入境,0,0,0,0
2020-02-03,红磡,出境,0,0,0,0
2020-02-03,罗湖,入境,27196,1873,368,29437
2020-02-03,罗湖,出境,14938,3078,320,18336
2020-02-03,落马洲支线,入境,17037,1038,242,18317
2020-02-03,落马洲支线,出境,10113,1815,205,12133
2020-02-03,港珠澳大桥,入境,3595,358,674,4627
2020-02-03,港珠澳大桥,出境,3023,723,849,4595
2020-02-03,落马洲,入境,9823,1206,281,11310
2020-02-03,落马洲,出境,5461,2150,190,7801
2020-02-03,文锦渡,入境,0,0,0,0
2020-02-03,文锦渡,出境,0,0,0,0
2020-02-03,沙头角,入境,0,0,0,0
2020-02-03,沙头角,出境,0,0,0,0
2020-02-03,深圳湾,入境,8284,1871,504,10659
2020-02-03,深圳湾,出境,3960,3754,486,8200
2020-02-03,中国客运码头,入境,0,0,0,0
2020-02-03,中国客运码头,出境,0,0,0,0
2020-02-03,港口管制,入境,0,0,25,25
2020-02-03,港口管制,出境,0,0,29,29
2020-02-03,启德邮轮码头,入境,330,22,6,358
2020-02-03,启德邮轮码头,出境,203,21,4,228
2020-02-03,港澳客轮码头,入境,3560,97,564,4221
2020-02-03,港澳客轮码头,出境,3333,109,589,4031
2020-02-03,屯门客运码头,入境,0,0,0,0
2020-02-03,屯门客运码头,出境,0,0,0,0
2020-02-04,机场,入境,31173,6317,3647,41137
2020-02-04,机场,出境,20187,3550,4471,28208
2020-02-04,高铁西九龙,入境,0,0,0,0
2020-02-04,高铁西九龙,出境,0,0,0,0
2020-02-04,红磡,入境,0,0,0,0
2020-02-04,红磡,出境,0,0,0,0
2020-02-04,罗湖,入境,0,0,0,0
2020-02-04,罗湖,出境,0,0,0,0
2020-02-04,落马洲支线,入境,0,0,0,0
2020-02-04,落马洲支线,出境,0,0,0,0
2020-02-04,港珠澳大桥,入境,4555,402,1020,5977
2020-02-04,港珠澳大桥,出境,3177,985,1020,5182
2020-02-04,落马洲,入境,0,0,0,0
2020-02-04,落马洲,出境,0,0,0,0
2020-02-04,文锦渡,入境,0,0,0,0
2020-02-04,文锦渡,出境,0,0,0,0
2020-02-04,沙头角,入境,0,0,0,0
2020-02-04,沙头角,出境,0,0,0,0
2020-02-04,深圳湾,入境,18852,2771,786,22409
2020-02-04,深圳湾,出境,10838,6731,809,18378
2020-02-04,中国客运码头,入境,0,0,0,0
2020-02-04,中国客运码头,出境,0,0,0,0
2020-02-04,港口管制,入境,33,0,30,63
2020-02-04,港口管制,出境,30,0,33,63
2020-02-04,启德邮轮码头,入境,203,21,2,226
2020-02-04,启德邮轮码头,出境,173,10,2,185
2020-02-04,港澳客轮码头,入境,0,0,0,0
2020-02-04,港澳客轮码头,出境,0,0,0,0
2020-02-04,屯门客运码头,入境,0,0,0,0
2020-02-04,屯门客运码头,出境,0,0,0,0
2020-02-05,机场,入境,24832,6041,3592,34465
2020-02-05,机场,出境,22297,2591,4404,29292
2020-02-05,高铁西九龙,入境,0,0,0,0
2020-02-05,高铁西九龙,出境,0,0,0,0
2020-02-05,红磡,入境,0,0,0,0
2020-02-05,红磡,出境,0,0,0,0
2020-02-05,罗湖,入境,0,0,0,0
2020-02-05,罗湖,出境,0,0,0,0
2020-02-05,落马洲支线,入境,0,0,0,0
2020-02-05,落马洲支线,出境,0,0,0,0
2020-02-05,港珠澳大桥,入境,3172,329,1121,4622
2020-02-05,港珠澳大桥,出境,2025,925,885,3835
2020-02-05,落马洲,入境,0,0,0,0
2020-02-05,落马洲,出境,0,0,0,0
2020-02-05,文锦渡,入境,0,0,0,0
2020-02-05,文锦渡,出境,0,0,0,0
2020-02-05,沙头角,入境,0,0,0,0
2020-02-05,沙头角,出境,0,0,0,0
2020-02-05,深圳湾,入境,16387,2378,714,19479
2020-02-05,深圳湾,出境,11893,6359,837,19089
2020-02-05,中国客运码头,入境,0,0,0,0
2020-02-05,中国客运码头,出境,0,0,0,0
2020-02-05,港口管制,入境,0,0,0,0
2020-02-05,港口管制,出境,0,0,0,0
2020-02-05,启德邮轮码头,入境,175,12,31,218
2020-02-05,启德邮轮码头,出境,2,2,0,4
2020-02-05,港澳客轮码头,入境,0,0,0,0
2020-02-05,港澳客轮码头,出境,0,0,0,0
2020-02-05,屯门客运码头,入境,0,0,0,0
2020-02-05,屯门客运码头,出境,0,0,0,0
2020-02-06,机场,入境,21261,5728,3478,30467
2020-02-06,机场,出境,22252,2512,4222,28986
2020-02-06,高铁西九龙,入境,0,0,0,0
2020-02-06,高铁西九龙,出境,0,0,0,0
2020-02-06,红磡,入境,0,0,0,0
2020-02-06,红磡,出境,0,0,0,0
2020-02-06,罗湖,入境,0,0,0,0
2020-02-06,罗湖,出境,0,0,0,0
2020-02-06,落马洲支线,入境,0,0,0,0
2020-02-06,落马洲支线,出境,0,0,0,0
2020-02-06,港珠澳大桥,入境,4941,468,1188,6597
2020-02-06,港珠澳大桥,出境,2608,1068,834,4510
2020-02-06,落马洲,入境,0,0,0,0
2020-02-06,落马洲,出境,0,0,0,0
2020-02-06,文锦渡,入境,0,0,0,0
2020-02-06,文锦渡,出境,0,0,0,0
2020-02-06,沙头角,入境,0,0,0,0
2020-02-06,沙头角,出境,0,0,0,0
2020-02-06,深圳湾,入境,38920,4813,1220,44953
2020-02-06,深圳湾,出境,21360,7071,1197,29628
2020-02-06,中国客运码头,入境,0,0,0,0
2020-02-06,中国客运码头,出境,0,0,0,0
2020-02-06,港口管制,入境,0,0,0,0
2020-02-06,港口管制,出境,0,0,0,0
2020-02-06,启德邮轮码头,入境,0,0,0,0
2020-02-06,启德邮轮码头,出境,0,0,0,0
2020-02-06,港澳客轮码头,入境,0,0,0,0
2020-02-06,港澳客轮码头,出境,0,0,0,0
2020-02-06,屯门客运码头,入境,0,0,0,0
2020-02-06,屯门客运码头,出境,0,0,0,0
2020-02-07,机场,入境,19694,5563,3556,28813
2020-02-07,机场,出境,21417,2735,4012,28164
2020-02-07,高铁西九龙,入境,0,0,0,0
2020-02-07,高铁西九龙,出境,0,0,0,0
2020-02-07,红磡,入境,0,0,0,0
2020-02-07,红磡,出境,0,0,0,0
2020-02-07,罗湖,入境,0,0,0,0
2020-02-07,罗湖,出境,0,0,0,0
2020-02-07,落马洲支线,入境,0,0,0,0
2020-02-07,落马洲支线,出境,0,0,0,0
2020-02-07,港珠澳大桥,入境,6699,628,1340,8667
2020-02-07,港珠澳大桥,出境,2576,1102,798,4476
2020-02-07,落马洲,入境,0,0,0,0
2020-02-07,落马洲,出境,0,0,0,0
2020-02-07,文锦渡,入境,0,0,0,0
2020-02-07,文锦渡,出境,0,0,0,0
2020-02-07,沙头角,入境,0,0,0,0
2020-02-07,沙头角,出境,0,0,0,0
2020-02-07,深圳湾,入境,50506,6555,1441,58502
2020-02-07,深圳湾,出境,16746,7282,1320,25348
2020-02-07,中国客运码头,入境,0,0,0,0
2020-02-07,中国客运码头,出境,0,0,0,0
2020-02-07,港口管制,入境,0,0,0,0
2020-02-07,港口管制,出境,0,0,0,0
2020-02-07,启德邮轮码头,入境,0,0,0,0
2020-02-07,启德邮轮码头,出境,0,0,0,0
2020-02-07,港澳客轮码头,入境,0,0,0,0
2020-02-07,港澳客轮码头,出境,0,0,0,0
2020-02-07,屯门客运码头,入境,0,0,0,0
2020-02-07,屯门客运码头,出境,0,0,0,0
2020-02-08,机场,入境,17956,943,3070,21969
2020-02-08,机场,出境,20163,1127,3253,24543
2020-02-08,高铁西九龙,入境,0,0,0,0
2020-02-08,高铁西九龙,出境,0,0,0,0
2020-02-08,红磡,入境,0,0,0,0
2020-02-08,红磡,出境,0,0,0,0
2020-02-08,罗湖,入境,0,0,0,0
2020-02-08,罗湖,出境,0,0,0,0
2020-02-08,落马洲支线,入境,0,0,0,0
2020-02-08,落马洲支线,出境,0,0,0,0
2020-02-08,港珠澳大桥,入境,659,9,508,1176
2020-02-08,港珠澳大桥,出境,750,163,442,1355
2020-02-08,落马洲,入境,0,0,0,0
2020-02-08,落马洲,出境,0,0,0,0
2020-02-08,文锦渡,入境,0,0,0,0
2020-02-08,文锦渡,出境,0,0,0,0
2020-02-08,沙头角,入境,0,0,0,0
2020-02-08,沙头角,出境,0,0,0,0
2020-02-08,深圳湾,入境,208,43,3,254
2020-02-08,深圳湾,出境,1291,1351,549,3191
2020-02-08,中国客运码头,入境,0,0,0,0
2020-02-08,中国客运码头,出境,0,0,0,0
2020-02-08,港口管制,入境,0,0,0,0
2020-02-08,港口管制,出境,0,0,0,0
2020-02-08,启德邮轮码头,入境,0,0,0,0
2020-02-08,启德邮轮码头,出境,0,0,0,0
2020-02-08,港澳客轮码头,入境,0,0,0,0
2020-02-08,港澳客轮码头,出境,0,0,0,0
2020-02-08,屯门客运码头,入境,0,0,0,0
2020-02-08,屯门客运码头,出境,0,0,0,0
2020-02-09,机场,入境,22077,913,2591,25581
2020-02-09,机场,出境,17782,971,3200,21953
2020-02-09,高铁西九龙,入境,0,0,0,0
2020-02-09,高铁西九龙,出境,0,0,0,0
2020-02-09,红磡,入境,0,0,0,0
2020-02-09,红磡,出境,0,0,0,0
2020-02-09,罗湖,入境,0,0,0,0
2020-02-09,罗湖,出境,0,0,0,0
2020-02-09,落马洲支线,入境,0,0,0,0
2020-02-09,落马洲支线,出境,0,0,0,0
2020-02-09,港珠澳大桥,入境,710,7,493,1210
2020-02-09,港珠澳大桥,出境,1185,167,524,1876
2020-02-09,落马洲,入境,0,0,0,0
2020-02-09,落马洲,出境,0,0,0,0
2020-02-09,文锦渡,入境,0,0,0,0
2020-02-09,文锦渡,出境,0,0,0,0
2020-02-09,沙头角,入境,0,0,0,0
2020-02-09,沙头角,出境,0,0,0,0
2020-02-09,深圳湾,入境,314,36,3,353
2020-02-09,深圳湾,出境,1802,1303,573,3678
2020-02-09,中国客运码头,入境,0,0,0,0
2020-02-09,中国客运码头,出境,0,0,0,0
2020-02-09,港口管制,入境,0,0,0,0
2020-02-09,港口管制,出境,0,0,0,0
2020-02-09,启德邮轮码头,入境,1838,0,33,1871
2020-02-09,启德邮轮码头,出境,0,0,0,0
2020-02-09,港澳客轮码头,入境,0,0,0,0
2020-02-09,港澳客轮码头,出境,0,0,0,0
2020-02-09,屯门客运码头,入境,0,0,0,0
2020-02-09,屯门客运码头,出境,0,0,0,0
2020-02-10,机场,入境,17139,766,2037,19942
2020-02-10,机场,出境,15550,535,3219,19304
2020-02-10,高铁西九龙,入境,0,0,0,0
2020-02-10,高铁西九龙,出境,0,0,0,0
2020-02-10,红磡,入境,0,0,0,0
2020-02-10,红磡,出境,0,0,0,0
2020-02-10,罗湖,入境,0,0,0,0
2020-02-10,罗湖,出境,0,0,0,0
2020-02-10,落马洲支线,入境,0,0,0,0
2020-02-10,落马洲支线,出境,0,0,0,0
2020-02-10,港珠澳大桥,入境,808,10,496,1314
2020-02-10,港珠澳大桥,出境,1508,137,444,2089
2020-02-10,落马洲,入境,0,0,0,0
2020-02-10,落马洲,出境,0,0,0,0
2020-02-10,文锦渡,入境,0,0,0,0
2020-02-10,文锦渡,出境,0,0,0,0
2020-02-10,沙头角,入境,0,0,0,0
2020-02-10,沙头角,出境,0,0,0,0
2020-02-10,深圳湾,入境,461,56,4,521
2020-02-10,深圳湾,出境,1835,1016,185,3036
2020-02-10,中国客运码头,入境,0,0,0,0
2020-02-10,中国客运码头,出境,0,0,0,0
2020-02-10,港口管制,入境,0,0,0,0
2020-02-10,港口管制,出境,0,0,0,0
2020-02-10,启德邮轮码头,入境,0,0,0,0
2020-02-10,启德邮轮码头,出境,0,0,0,0
2020-02-10,港澳客轮码头,入境,0,0,0,0
2020-02-10,港澳客轮码头,出境,0,0,0,0
2020-02-10,屯门客运码头,入境,0,0,0,0
2020-02-10,屯门客运码头,出境,0,0,0,0
2020-02-11,机场,入境,14663,647,2107,17417
2020-02-11,机场,出境,12645,481,2556,15682
2020-02-11,高铁西九龙,入境,0,0,0,0
2020-02-11,高铁西九龙,出境,0,0,0,0
2020-02-11,红磡,入境,0,0,0,0
2020-02-11,红磡,出境,0,0,0,0
2020-02-11,罗湖,入境,0,0,0,0
2020-02-11,罗湖,出境,0,0,0,0
2020-02-11,落马洲支线,入境,0,0,0,0
2020-02-11,落马洲支线,出境,0,0,0,0
2020-02-11,港珠澳大桥,入境,729,11,458,1198
2020-02-11,港珠澳大桥,出境,960,103,452,1515
2020-02-11,落马洲,入境,0,0,0,0
2020-02-11,落马洲,出境,0,0,0,0
2020-02-11,文锦渡,入境,0,0,0,0
2020-02-11,文锦渡,出境,0,0,0,0
2020-02-11,沙头角,入境,0,0,0,0
2020-02-11,沙头角,出境,0,0,0,0
2020-02-11,深圳湾,入境,561,80,4,645
2020-02-11,深圳湾,出境,1105,739,140,1984
2020-02-11,中国客运码头,入境,0,0,0,0
2020-02-11,中国客运码头,出境,0,0,0,0
2020-02-11,港口管制,入境,0,0,0,0
2020-02-11,港口管制,出境,0,0,0,0
2020-02-11,启德邮轮码头,入境,0,0,0,0
2020-02-11,启德邮轮码头,出境,0,0,0,0
2020-02-11,港澳客轮码头,入境,0,0,0,0
2020-02-11,港澳客轮码头,出境,0,0,0,0
2020-02-11,屯门客运码头,入境,0,0,0,0
2020-02-11,屯门客运码头,出境,0,0,0,0
2020-02-12,机场,入境,14221,619,1725,16565
2020-02-12,机场,出境,13637,471,2358,16466
2020-02-12,高铁西九龙,入境,0,0,0,0
2020-02-12,高铁西九龙,出境,0,0,0,0
2020-02-12,红磡,入境,0,0,0,0
2020-02-12,红磡,出境,0,0,0,0
2020-02-12,罗湖,入境,0,0,0,0
2020-02-12,罗湖,出境,0,0,0,0
2020-02-12,落马洲支线,入境,0,0,0,0
2020-02-12,落马洲支线,出境,0,0,0,0
2020-02-12,港珠澳大桥,入境,862,4,449,1315
2020-02-12,港珠澳大桥,出境,904,109,350,1363
2020-02-12,落马洲,入境,0,0,0,0
2020-02-12,落马洲,出境,0,0,0,0
2020-02-12,文锦渡,入境,0,0,0,0
2020-02-12,文锦渡,出境,0,0,0,0
2020-02-12,沙头角,入境,0,0,0,0
2020-02-12,沙头角,出境,0,0,0,0
2020-02-12,深圳湾,入境,709,106,2,817
2020-02-12,深圳湾,出境,1219,862,114,2195
2020-02-12,中国客运码头,入境,0,0,0,0
2020-02-12,中国客运码头,出境,0,0,0,0
2020-02-12,港口管制,入境,0,0,0,0
2020-02-12,港口管制,出境,0,0,0,0
2020-02-12,启德邮轮码头,入境,0,0,0,0
2020-02-12,启德邮轮码头,出境,0,0,0,0
2020-02-12,港澳客轮码头,入境,0,0,0,0
2020-02-12,港澳客轮码头,出境,0,0,0,0
2020-02-12,屯门客运码头,入境,0,0,0,0
2020-02-12,屯门客运码头,出境,0,0,0,0
2020-02-13,机场,入境,11620,638,1938,14196
2020-02-13,机场,出境,15259,453,2150,17862
2020-02-13,高铁西九龙,入境,0,0,0,0
2020-02-13,高铁西九龙,出境,0,0,0,0
2020-02-13,红磡,入境,0,0,0,0
2020-02-13,红磡,出境,0,0,0,0
2020-02-13,罗湖,入境,0,0,0,0
2020-02-13,罗湖,出境,0,0,0,0
2020-02-13,落马洲支线,入境,0,0,0,0
2020-02-13,落马洲支线,出境,0,0,0,0
2020-02-13,港珠澳大桥,入境,936,8,503,1447
2020-02-13,港珠澳大桥,出境,1089,124,450,1663
2020-02-13,落马洲,入境,0,0,0,0
2020-02-13,落马洲,出境,0,0,0,0
2020-02-13,文锦渡,入境,0,0,0,0
2020-02-13,文锦渡,出境,0,0,0,0
2020-02-13,沙头角,入境,0,0,0,0
2020-02-13,沙头角,出境,0,0,0,0
2020-02-13,深圳湾,入境,756,105,17,878
2020-02-13,深圳湾,出境,1056,856,104,2016
2020-02-13,中国客运码头,入境,0,0,0,0
2020-02-13,中国客运码头,出境,0,0,0,0
2020-02-13,港口管制,入境,0,0,0,0
2020-02-13,港口管制,出境,0,0,0,0
2020-02-13,启德邮轮码头,入境,0,0,0,0
2020-02-13,启德邮轮码头,出境,0,0,0,0
2020-02-13,港澳客轮码头,入境,0,0,0,0
2020-02-13,港澳客轮码头,出境,0,0,0,0
2020-02-13,屯门客运码头,入境,0,0,0,0
2020-02-13,屯门客运码头,出境,0,0,0,0
2020-02-14,机场,入境,11246,584,2015,13845
2020-02-14,机场,出境,15770,477,2012,18259
2020-02-14,高铁西九龙,入境,0,0,0,0
2020-02-14,高铁西九龙,出境,0,0,0,0
2020-02-14,红磡,入境,0,0,0,0
2020-02-14,红磡,出境,0,0,0,0
2020-02-14,罗湖,入境,0,0,0,0
2020-02-14,罗湖,出境,0,0,0,0
2020-02-14,落马洲支线,入境,0,0,0,0
2020-02-14,落马洲支线,出境,0,0,0,0
2020-02-14,港珠澳大桥,入境,1491,5,553,2049
2020-02-14,港珠澳大桥,出境,1298,110,447,1855
2020-02-14,落马洲,入境,0,0,0,0
2020-02-14,落马洲,出境,0,0,0,0
2020-02-14,文锦渡,入境,0,0,0,0
2020-02-14,文锦渡,出境,0,0,0,0
2020-02-14,沙头角,入境,0,0,0,0
2020-02-14,沙头角,出境,0,0,0,0
2020-02-14,深圳湾,入境,770,94,6,870
2020-02-14,深圳湾,出境,1092,1016,117,2225
2020-02-14,中国客运码头,入境,0,0,0,0
2020-02-14,中国客运码头,出境,0,0,0,0
2020-02-14,港口管制,入境,0,0,0,0
2020-02-14,港口管制,出境,0,0,0,0
2020-02-14,启德邮轮码头,入境,0,0,0,0
2020-02-14,启德邮轮码头,出境,0,0,0,0
2020-02-14,港澳客轮码头,入境,0,0,0,0
2020-02-14,港澳客轮码头,出境,0,0,0,0
2020-02-14,屯门客运码头,入境,0,0,0,0
2020-02-14,屯门客运码头,出境,0,0,0,0
2020-02-15,机场,入境,14097,692,2098,16887
2020-02-15,机场,出境,14575,390,2064,17029
2020-02-15,高铁西九龙,入境,0,0,0,0
2020-02-15,高铁西九龙,出境,0,0,0,0
2020-02-15,红磡,入境,0,0,0,0
2020-02-15,红磡,出境,0,0,0,0
2020-02-15,罗湖,入境,0,0,0,0
2020-02-15,罗湖,出境,0,0,0,0
2020-02-15,落马洲支线,入境,0,0,0,0
2020-02-15,落马洲支线,出境,0,0,0,0
2020-02-15,港珠澳大桥,入境,1183,5,524,1712
2020-02-15,港珠澳大桥,出境,1060,119,486,1665
2020-02-15,落马洲,入境,0,0,0,0
2020-02-15,落马洲,出境,0,0,0,0
2020-02-15,文锦渡,入境,0,0,0,0
2020-02-15,文锦渡,出境,0,0,0,0
2020-02-15,沙头角,入境,0,0,0,0
2020-02-15,沙头角,出境,0,0,0,0
2020-02-15,深圳湾,入境,809,94,7,910
2020-02-15,深圳湾,出境,945,621,150,1716
2020-02-15,中国客运码头,入境,0,0,0,0
2020-02-15,中国客运码头,出境,0,0,0,0
2020-02-15,港口管制,入境,0,0,0,0
2020-02-15,港口管制,出境,0,0,0,0
2020-02-15,启德邮轮码头,入境,0,0,0,0
2020-02-15,启德邮轮码头,出境,0,0,0,0
2020-02-15,港澳客轮码头,入境,0,0,0,0
2020-02-15,港澳客轮码头,出境,0,0,0,0
2020-02-15,屯门客运码头,入境,0,0,0,0
2020-02-15,屯门客运码头,出境,0,0,0,0
2020-02-16,机场,入境,18422,650,1848,20920
2020-02-16,机场,出境,12257,349,2524,15130
2020-02-16,高铁西九龙,入境,0,0,0,0
2020-02-16,高铁西九龙,出境,0,0,0,0
2020-02-16,红磡,入境,0,0,0,0
2020-02-16,红磡,出境,0,0,0,0
2020-02-16,罗湖,入境,0,0,0,0
2020-02-16,罗湖,出境,0,0,0,0
2020-02-16,落马洲支线,入境,0,0,0,0
2020-02-16,落马洲支线,出境,0,0,0,0
2020-02-16,港珠澳大桥,入境,1106,2,465,1573
2020-02-16,港珠澳大桥,出境,1473,76,646,2195
2020-02-16,落马洲,入境,0,0,0,0
2020-02-16,落马洲,出境,0,0,0,0
2020-02-16,文锦渡,入境,0,0,0,0
2020-02-16,文锦渡,出境,0,0,0,0
2020-02-16,沙头角,入境,0,0,0,0
2020-02-16,沙头角,出境,0,0,0,0
2020-02-16,深圳湾,入境,797,97,6,900
2020-02-16,深圳湾,出境,1166,764,203,2133
2020-02-16,中国客运码头,入境,0,0,0,0
2020-02-16,中国客运码头,出境,0,0,0,0
2020-02-16,港口管制,入境,0,0,0,0
2020-02-16,港口管制,出境,0,0,0,0
2020-02-16,启德邮轮码头,入境,0,0,0,0
2020-02-16,启德邮轮码头,出境,0,0,0,0
2020-02-16,港澳客轮码头,入境,0,0,0,0
2020-02-16,港澳客轮码头,出境,0,0,0,0
2020-02-16,屯门客运码头,入境,0,0,0,0
2020-02-16,屯门客运码头,出境,0,0,0,0
2020-02-17,机场,入境,13748,532,1876,16156
2020-02-17,机场,出境,10210,212,2018,12440
2020-02-17,高铁西九龙,入境,0,0,0,0
2020-02-17,高铁西九龙,出境,0,0,0,0
2020-02-17,红磡,入境,0,0,0,0
2020-02-17,红磡,出境,0,0,0,0
2020-02-17,罗湖,入境,0,0,0,0
2020-02-17,罗湖,出境,0,0,0,0
2020-02-17,落马洲支线,入境,0,0,0,0
2020-02-17,落马洲支线,出境,0,0,0,0
2020-02-17,港珠澳大桥,入境,1264,3,488,1755
2020-02-17,港珠澳大桥,出境,2000,87,625,2712
2020-02-17,落马洲,入境,0,0,0,0
2020-02-17,落马洲,出境,0,0,0,0
2020-02-17,文锦渡,入境,0,0,0,0
2020-02-17,文锦渡,出境,0,0,0,0
2020-02-17,沙头角,入境,0,0,0,0
2020-02-17,沙头角,出境,0,0,0,0
2020-02-17,深圳湾,入境,978,108,4,1090
2020-02-17,深圳湾,出境,1724,600,173,2497
2020-02-17,中国客运码头,入境,0,0,0,0
2020-02-17,中国客运码头,出境,0,0,0,0
2020-02-17,港口管制,入境,0,0,0,0
2020-02-17,港口管制,出境,0,0,0,0
2020-02-17,启德邮轮码头,入境,0,0,0,0
2020-02-17,启德邮轮码头,出境,0,0,0,0
2020-02-17,港澳客轮码头,入境,0,0,0,0
2020-02-17,港澳客轮码头,出境,0,0,0,0
2020-02-17,屯门客运码头,入境,0,0,0,0
2020-02-17,屯门客运码头,出境,0,0,0,0
2020-02-18,机场,入境,12068,479,1862,14409
2020-02-18,机场,出境,8900,266,1722,10888
2020-02-18,高铁西九龙,入境,0,0,0,0
2020-02-18,高铁西九龙,出境,0,0,0,0
2020-02-18,红磡,入境,0,0,0,0
2020-02-18,红磡,出境,0,0,0,0
2020-02-18,罗湖,入境,0,0,0,0
2020-02-18,罗湖,出境,0,0,0,0
2020-02-18,落马洲支线,入境,0,0,0,0
2020-02-18,落马洲支线,出境,0,0,0,0
2020-02-18,港珠澳大桥,入境,1361,5,579,1945
2020-02-18,港珠澳大桥,出境,1955,74,730,2759
2020-02-18,落马洲,入境,0,0,0,0
2020-02-18,落马洲,出境,0,0,0,0
2020-02-18,文锦渡,入境,0,0,0,0
2020-02-18,文锦渡,出境,0,0,0,0
2020-02-18,沙头角,入境,0,0,0,0
2020-02-18,沙头角,出境,0,0,0,0
2020-02-18,深圳湾,入境,954,95,10,1059
2020-02-18,深圳湾,出境,1160,519,155,1834
2020-02-18,中国客运码头,入境,0,0,0,0
2020-02-18,中国客运码头,出境,0,0,0,0
2020-02-18,港口管制,入境,0,0,0,0
2020-02-18,港口管制,出境,0,0,0,0
2020-02-18,启德邮轮码头,入境,0,0,0,0
2020-02-18,启德邮轮码头,出境,0,0,0,0
2020-02-18,港澳客轮码头,入境,0,0,0,0
2020-02-18,港澳客轮码头,出境,0,0,0,0
2020-02-18,屯门客运码头,入境,0,0,0,0
2020-02-18,屯门客运码头,出境,0,0,0,0
2020-02-19,机场,入境,10612,462,1789,12863
2020-02-19,机场,出境,10048,214,1582,11844
2020-02-19,高铁西九龙,入境,0,0,0,0
2020-02-19,高铁西九龙,出境,0,0,0,0
2020-02-19,红磡,入境,0,0,0,0
2020-02-19,红磡,出境,0,0,0,0
2020-02-19,罗湖,入境,0,0,0,0
2020-02-19,罗湖,出境,0,0,0,0
2020-02-19,落马洲支线,入境,0,0,0,0
2020-02-19,落马洲支线,出境,0,0,0,0
2020-02-19,港珠澳大桥,入境,1280,8,496,1784
2020-02-19,港珠澳大桥,出境,1776,64,609,2449
2020-02-19,落马洲,入境,0,0,0,0
2020-02-19,落马洲,出境,0,0,0,0
2020-02-19,文锦渡,入境,0,0,0,0
2020-02-19,文锦渡,出境,0,0,0,0
2020-02-19,沙头角,入境,0,0,0,0
2020-02-19,沙头角,出境,0,0,0,0
2020-02-19,深圳湾,入境,909,97,5,1011
2020-02-19,深圳湾,出境,1145,508,113,1766
2020-02-19,中国客运码头,入境,0,0,0,0
2020-02-19,中国客运码头,出境,0,0,0,0
2020-02-19,港口管制,入境,0,0,0,0
2020-02-19,港口管制,出境,0,0,0,0
2020-02-19,启德邮轮码头,入境,0,0,0,0
2020-02-19,启德邮轮码头,出境,0,0,0,0
2020-02-19,港澳客轮码头,入境,0,0,0,0
2020-02-19,港澳客轮码头,出境,0,0,0,0
2020-02-19,屯门客运码头,入境,0,0,0,0
2020-02-19,屯门客运码头,出境,0,0,0,0
2020-02-20,机场,入境,10398,525,1730,12653
2020-02-20,机场,出境,11622,280,1944,13846
2020-02-20,高铁西九龙,入境,0,0,0,0
2020-02-20,高铁西九龙,出境,0,0,0,0
2020-02-20,红磡,入境,0,0,0,0
2020-02-20,红磡,出境,0,0,0,0
2020-02-20,罗湖,入境,0,0,0,0
2020-02-20,罗湖,出境,0,0,0,0
2020-02-20,落马洲支线,入境,0,0,0,0
2020-02-20,落马洲支线,出境,0,0,0,0
2020-02-20,港珠澳大桥,入境,2299,13,585,2897
2020-02-20,港珠澳大桥,出境,3135,96,551,3782
2020-02-20,落马洲,入境,0,0,0,0
2020-02-20,落马洲,出境,0,0,0,0
2020-02-20,文锦渡,入境,0,0,0,0
2020-02-20,文锦渡,出境,0,0,0,0
2020-02-20,沙头角,入境,0,0,0,0
2020-02-20,沙头角,出境,0,0,0,0
2020-02-20,深圳湾,入境,980,110,9,1099
2020-02-20,深圳湾,出境,1167,564,111,1842
2020-02-20,中国客运码头,入境,0,0,0,0
2020-02-20,中国客运码头,出境,0,0,0,0
2020-02-20,港口管制,入境,0,0,0,0
2020-02-20,港口管制,出境,0,0,0,0
2020-02-20,启德邮轮码头,入境,0,0,0,0
2020-02-20,启德邮轮码头,出境,0,0,0,0
2020-02-20,港澳客轮码头,入境,0,0,0,0
2020-02-20,港澳客轮码头,出境,0,0,0,0
2020-02-20,屯门客运码头,入境,0,0,0,0
2020-02-20,屯门客运码头,出境,0,0,0,0
2020-02-21,机场,入境,9821,539,2007,12367
2020-02-21,机场,出境,12942,356,1749,15047
2020-02-21,高铁西九龙,入境,0,0,0,0
2020-02-21,高铁西九龙,出境,0,0,0,0
2020-02-21,红磡,入境,0,0,0,0
2020-02-21,红磡,出境,0,0,0,0
2020-02-21,罗湖,入境,0,0,0,0
2020-02-21,罗湖,出境,0,0,0,0
2020-02-21,落马洲支线,入境,0,0,0,0
2020-02-21,落马洲支线,出境,0,0,0,0
2020-02-21,港珠澳大桥,入境,3647,28,685,4360
2020-02-21,港珠澳大桥,出境,3362,95,549,4006
2020-02-21,落马洲,入境,0,0,0,0
2020-02-21,落马洲,出境,0,0,0,0
2020-02-21,文锦渡,入境,0,0,0,0
2020-02-21,文锦渡,出境,0,0,0,0
2020-02-21,沙头角,入境,0,0,0,0
2020-02-21,沙头角,出境,0,0,0,0
2020-02-21,深圳湾,入境,1089,115,4,1208
2020-02-21,深圳湾,出境,1195,534,115,1844
2020-02-21,中国客运码头,入境,0,0,0,0
2020-02-21,中国客运码头,出境,0,0,0,0
2020-02-21,港口管制,入境,0,0,0,0
2020-02-21,港口管制,出境,0,0,0,0
2020-02-21,启德邮轮码头,入境,0,0,0,0
2020-02-21,启德邮轮码头,出境,0,0,0,0
2020-02-21,港澳客轮码头,入境,0,0,0,0
2020-02-21,港澳客轮码头,出境,0,0,0,0
2020-02-21,屯门客运码头,入境,0,0,0,0
2020-02-21,屯门客运码头,出境,0,0,0,0
2020-02-22,机场,入境,11096,530,2030,13656
2020-02-22,机场,出境,10534,247,1888,12669
2020-02-22,高铁西九龙,入境,0,0,0,0
2020-02-22,高铁西九龙,出境,0,0,0,0
2020-02-22,红磡,入境,0,0,0,0
2020-02-22,红磡,出境,0,0,0,0
2020-02-22,罗湖,入境,0,0,0,0
2020-02-22,罗湖,出境,0,0,0,0
2020-02-22,落马洲支线,入境,0,0,0,0
2020-02-22,落马洲支线,出境,0,0,0,0
2020-02-22,港珠澳大桥,入境,3364,14,648,4026
2020-02-22,港珠澳大桥,出境,3511,83,641,4235
2020-02-22,落马洲,入境,0,0,0,0
2020-02-22,落马洲,出境,0,0,0,0
2020-02-22,文锦渡,入境,0,0,0,0
2020-02-22,文锦渡,出境,0,0,0,0
2020-02-22,沙头角,入境,0,0,0,0
2020-02-22,沙头角,出境,0,0,0,0
2020-02-22,深圳湾,入境,980,107,2,1089
2020-02-22,深圳湾,出境,1115,487,124,1726
2020-02-22,中国客运码头,入境,0,0,0,0
2020-02-22,中国客运码头,出境,0,0,0,0
2020-02-22,港口管制,入境,0,0,0,0
2020-02-22,港口管制,出境,0,0,0,0
2020-02-22,启德邮轮码头,入境,0,0,0,0
2020-02-22,启德邮轮码头,出境,0,0,0,0
2020-02-22,港澳客轮码头,入境,0,0,0,0
2020-02-22,港澳客轮码头,出境,0,0,0,0
2020-02-22,屯门客运码头,入境,0,0,0,0
2020-02-22,屯门客运码头,出境,0,0,0,0
2020-02-23,机场,入境,15891,537,2009,18437
2020-02-23,机场,出境,9225,296,2141,11662
2020-02-23,高铁西九龙,入境,0,0,0,0
2020-02-23,高铁西九龙,出境,0,0,0,0
2020-02-23,红磡,入境,0,0,0,0
2020-02-23,红磡,出境,0,0,0,0
2020-02-23,罗湖,入境,0,0,0,0
2020-02-23,罗湖,出境,0,0,0,0
2020-02-23,落马洲支线,入境,0,0,0,0
2020-02-23,落马洲支线,出境,0,0,0,0
2020-02-23,港珠澳大桥,入境,3203,10,633,3846
2020-02-23,港珠澳大桥,出境,3342,86,775,4203
2020-02-23,落马洲,入境,0,0,0,0
2020-02-23,落马洲,出境,0,0,0,0
2020-02-23,文锦渡,入境,0,0,0,0
2020-02-23,文锦渡,出境,0,0,0,0
2020-02-23,沙头角,入境,0,0,0,0
2020-02-23,沙头角,出境,0,0,0,0
2020-02-23,深圳湾,入境,1147,126,9,1282
2020-02-23,深圳湾,出境,1338,579,273,2190
2020-02-23,中国客运码头,入境,0,0,0,0
2020-02-23,中国客运码头,出境,0,0,0,0
2020-02-23,港口管制,入境,0,0,0,0
2020-02-23,港口管制,出境,0,0,0,0
2020-02-23,启德邮轮码头,入境,0,0,0,0
2020-02-23,启德邮轮码头,出境,0,0,0,0
2020-02-23,港澳客轮码头,入境,0,0,0,0
2020-02-23,港澳客轮码头,出境,0,0,0,0
2020-02-23,屯门客运码头,入境,0,0,0,0
2020-02-23,屯门客运码头,出境,0,0,0,0
2020-02-24,机场,入境,12267,451,1792,14510
2020-02-24,机场,出境,8041,231,1919,10191
2020-02-24,高铁西九龙,入境,0,0,0,0
2020-02-24,高铁西九龙,出境,0,0,0,0
2020-02-24,红磡,入境,0,0,0,0
2020-02-24,红磡,出境,0,0,0,0
2020-02-24,罗湖,入境,0,0,0,0
2020-02-24,罗湖,出境,0,0,0,0
2020-02-24,落马洲支线,入境,0,0,0,0
2020-02-24,落马洲支线,出境,0,0,0,0
2020-02-24,港珠澳大桥,入境,3352,7,611,3970
2020-02-24,港珠澳大桥,出境,4211,74,682,4967
2020-02-24,落马洲,入境,0,0,0,0
2020-02-24,落马洲,出境,0,0,0,0
2020-02-24,文锦渡,入境,0,0,0,0
2020-02-24,文锦渡,出境,0,0,0,0
2020-02-24,沙头角,入境,0,0,0,0
2020-02-24,沙头角,出境,0,0,0,0
2020-02-24,深圳湾,入境,1353,130,7,1490
2020-02-24,深圳湾,出境,1964,482,181,2627
2020-02-24,中国客运码头,入境,0,0,0,0
2020-02-24,中国客运码头,出境,0,0,0,0
2020-02-24,港口管制,入境,0,0,0,0
2020-02-24,港口管制,出境,0,0,0,0
2020-02-24,启德邮轮码头,入境,0,0,0,0
2020-02-24,启德邮轮码头,出境,0,0,0,0
2020-02-24,港澳客轮码头,入境,0,0,0,0
2020-02-24,港澳客轮码头,出境,0,0,0,0
2020-02-24,屯门客运码头,入境,0,0,0,0
2020-02-24,屯门客运码头,出境,0,0,0,0
2020-02-25,机场,入境,10734,414,1471,12619
2020-02-25,机场,出境,7458,181,1574,9213
2020-02-25,高铁西九龙,入境,0,0,0,0
2020-02-25,高铁西九龙,出境,0,0,0,0
2020-02-25,红磡,入境,0,0,0,0
2020-02-25,红磡,出境,0,0,0,0
2020-02-25,罗湖,入境,0,0,0,0
2020-02-25,罗湖,出境,0,0,0,0
2020-02-25,落马洲支线,入境,0,0,0,0
2020-02-25,落马洲支线,出境,0,0,0,0
2020-02-25,港珠澳大桥,入境,3145,13,591,3749
2020-02-25,港珠澳大桥,出境,3281,88,593,3962
2020-02-25,落马洲,入境,0,0,0,0
2020-02-25,落马洲,出境,0,0,0,0
2020-02-25,文锦渡,入境,0,0,0,0
2020-02-25,文锦渡,出境,0,0,0,0
2020-02-25,沙头角,入境,0,0,0,0
2020-02-25,沙头角,出境,0,0,0,0
2020-02-25,深圳湾,入境,1328,131,5,1464
2020-02-25,深圳湾,出境,1510,503,141,2154
2020-02-25,中国客运码头,入境,0,0,0,0
2020-02-25,中国客运码头,出境,0,0,0,0
2020-02-25,港口管制,入境,0,0,0,0
2020-02-25,港口管制,出境,0,0,0,0
2020-02-25,启德邮轮码头,入境,0,0,0,0
2020-02-25,启德邮轮码头,出境,0,0,0,0
2020-02-25,港澳客轮码头,入境,0,0,0,0
2020-02-25,港澳客轮码头,出境,0,0,0,0
2020-02-25,屯门客运码头,入境,0,0,0,0
2020-02-25,屯门客运码头,出境,0,0,0,0
2020-02-26,机场,入境,9882,410,1484,11776
2020-02-26,机场,出境,7629,212,1521,9362
2020-02-26,高铁西九龙,入境,0,0,0,0
2020-02-26,高铁西九龙,出境,0,0,0,0
2020-02-26,红磡,入境,0,0,0,0
2020-02-26,红磡,出境,0,0,0,0
2020-02-26,罗湖,入境,0,0,0,0
2020-02-26,罗湖,出境,0,0,0,0
2020-02-26,落马洲支线,入境,0,0,0,0
2020-02-26,落马洲支线,出境,0,0,0,0
2020-02-26,港珠澳大桥,入境,3233,11,662,3906
2020-02-26,港珠澳大桥,出境,3424,78,580,4082
2020-02-26,落马洲,入境,0,0,0,0
2020-02-26,落马洲,出境,0,0,0,0
2020-02-26,文锦渡,入境,0,0,0,0
2020-02-26,文锦渡,出境,0,0,0,0
2020-02-26,沙头角,入境,0,0,0,0
2020-02-26,沙头角,出境,0,0,0,0
2020-02-26,深圳湾,入境,1202,166,11,1379
2020-02-26,深圳湾,出境,1695,548,179,2422
2020-02-26,中国客运码头,入境,0,0,0,0
2020-02-26,中国客运码头,出境,0,0,0,0
2020-02-26,港口管制,入境,0,0,0,0
2020-02-26,港口管制,出境,0,0,0,0
2020-02-26,启德邮轮码头,入境,0,0,0,0
2020-02-26,启德邮轮码头,出境,0,0,0,0
2020-02-26,港澳客轮码头,入境,0,0,0,0
2020-02-26,港澳客轮码头,出境,0,0,0,0
2020-02-26,屯门客运码头,入境,0,0,0,0
2020-02-26,屯门客运码头,出境,0,0,0,0
2020-02-27,机场,入境,9177,512,1780,11469
2020-02-27,机场,出境,9051,168,1501,10720
2020-02-27,高铁西九龙,入境,0,0,0,0
2020-02-27,高铁西九龙,出境,0,0,0,0
2020-02-27,红磡,入境,0,0,0,0
2020-02-27,红磡,出境,0,0,0,0
2020-02-27,罗湖,入境,0,0,0,0
2020-02-27,罗湖,出境,0,0,0,0
2020-02-27,落马洲支线,入境,0,0,0,0
2020-02-27,落马洲支线,出境,0,0,0,0
2020-02-27,港珠澳大桥,入境,3420,20,616,4056
2020-02-27,港珠澳大桥,出境,3672,99,670,4441
2020-02-27,落马洲,入境,0,0,0,0
2020-02-27,落马洲,出境,0,0,0,0
2020-02-27,文锦渡,入境,0,0,0,0
2020-02-27,文锦渡,出境,0,0,0,0
2020-02-27,沙头角,入境,0,0,0,0
2020-02-27,沙头角,出境,0,0,0,0
2020-02-27,深圳湾,入境,1249,170,8,1427
2020-02-27,深圳湾,出境,1564,647,183,2394
2020-02-27,中国客运码头,入境,0,0,0,0
2020-02-27,中国客运码头,出境,0,0,0,0
2020-02-27,港口管制,入境,0,0,0,0
2020-02-27,港口管制,出境,0,0,0,0
2020-02-27,启德邮轮码头,入境,0,0,0,0
2020-02-27,启德邮轮码头,出境,0,0,0,0
2020-02-27,港澳客轮码头,入境,0,0,0,0
2020-02-27,港澳客轮码头,出境,0,0,0,0
2020-02-27,屯门客运码头,入境,0,0,0,0
2020-02-27,屯门客运码头,出境,0,0,0,0
2020-02-28,机场,入境,9205,369,1767,11341
2020-02-28,机场,出境,10755,255,1747,12757
2020-02-28,高铁西九龙,入境,0,0,0,0
2020-02-28,高铁西九龙,出境,0,0,0,0
2020-02-28,红磡,入境,0,0,0,0
2020-02-28,红磡,出境,0,0,0,0
2020-02-28,罗湖,入境,0,0,0,0
2020-02-28,罗湖,出境,0,0,0,0
2020-02-28,落马洲支线,入境,0,0,0,0
2020-02-28,落马洲支线,出境,0,0,0,0
2020-02-28,港珠澳大桥,入境,4763,8,865,5636
2020-02-28,港珠澳大桥,出境,4669,90,663,5422
2020-02-28,落马洲,入境,0,0,0,0
2020-02-28,落马洲,出境,0,0,0,0
2020-02-28,文锦渡,入境,0,0,0,0
2020-02-28,文锦渡,出境,0,0,0,0
2020-02-28,沙头角,入境,0,0,0,0
2020-02-28,沙头角,出境,0,0,0,0
2020-02-28,深圳湾,入境,1280,181,10,1471
2020-02-28,深圳湾,出境,1724,566,175,2465
2020-02-28,中国客运码头,入境,0,0,0,0
2020-02-28,中国客运码头,出境,0,0,0,0
2020-02-28,港口管制,入境,0,0,0,0
2020-02-28,港口管制,出境,0,0,0,0
2020-02-28,启德邮轮码头,入境,0,0,0,0
2020-02-28,启德邮轮码头,出境,0,0,0,0
2020-02-28,港澳客轮码头,入境,0,0,0,0
2020-02-28,港澳客轮码头,出境,0,0,0,0
2020-02-28,屯门客运码头,入境,0,0,0,0
2020-02-28,屯门客运码头,出境,0,0,0,0
2020-02-29,机场,入境,11818,870,1893,14581
2020-02-29,机场,出境,9860,230,1688,11778
2020-02-29,高铁西九龙,入境,0,0,0,0
2020-02-29,高铁西九龙,出境,0,0,0,0
2020-02-29,红磡,入境,0,0,0,0
2020-02-29,红磡,出境,0,0,0,0
2020-02-29,罗湖,入境,0,0,0,0
2020-02-29,罗湖,出境,0,0,0,0
2020-02-29,落马洲支线,入境,0,0,0,0
2020-02-29,落马洲支线,出境,0,0,0,0
2020-02-29,港珠澳大桥,入境,4676,19,901,5596
2020-02-29,港珠澳大桥,出境,4866,87,787,5740
2020-02-29,落马洲,入境,0,0,0,0
2020-02-29,落马洲,出境,0,0,0,0
2020-02-29,文锦渡,入境,0,0,0,0
2020-02-29,文锦渡,出境,0,0,0,0
2020-02-29,沙头角,入境,0,0,0,0
2020-02-29,沙头角,出境,0,0,0,0
2020-02-29,深圳湾,入境,1387,195,3,1585
2020-02-29,深圳湾,出境,1807,947,329,3083
2020-02-29,中国客运码头,入境,0,0,0,0
2020-02-29,中国客运码头,出境,0,0,0,0
2020-02-29,港口管制,入境,0,0,0,0
2020-02-29,港口管制,出境,0,0,0,0
2020-02-29,启德邮轮码头,入境,0,0,0,0
2020-02-29,启德邮轮码头,出境,0,0,0,0
2020-02-29,港澳客轮码头,入境,0,0,0,0
2020-02-29,港澳客轮码头,出境,0,0,0,0
2020-02-29,屯门客运码头,入境,0,0,0,0
2020-02-29,屯门客运码头,出境,0,0,0,0
2020-03-01,机场,入境,14584,1122,2461,18167
2020-03-01,机场,出境,9115,354,1850,11319
2020-03-01,高铁西九龙,入境,0,0,0,0
2020-03-01,高铁西九龙,出境,0,0,0,0
2020-03-01,红磡,入境,0,0,0,0
2020-03-01,红磡,出境,0,0,0,0
2020-03-01,罗湖,入境,0,0,0,0
2020-03-01,罗湖,出境,0,0,0,0
2020-03-01,落马洲支线,入境,0,0,0,0
2020-03-01,落马洲支线,出境,0,0,0,0
2020-03-01,港珠澳大桥,入境,4820,13,767,5600
2020-03-01,港珠澳大桥,出境,4587,194,905,5686
2020-03-01,落马洲,入境,0,0,0,0
2020-03-01,落马洲,出境,0,0,0,0
2020-03-01,文锦渡,入境,0,0,0,0
2020-03-01,文锦渡,出境,0,0,0,0
2020-03-01,沙头角,入境,0,0,0,0
2020-03-01,沙头角,出境,0,0,0,0
2020-03-01,深圳湾,入境,1587,211,9,1807
2020-03-01,深圳湾,出境,2053,1247,931,4231
2020-03-01,中国客运码头,入境,0,0,0,0
2020-03-01,中国客运码头,出境,0,0,0,0
2020-03-01,港口管制,入境,0,0,0,0
2020-03-01,港口管制,出境,0,0,0,0
2020-03-01,启德邮轮码头,入境,0,0,0,0
2020-03-01,启德邮轮码头,出境,0,0,0,0
2020-03-01,港澳客轮码头,入境,0,0,0,0
2020-03-01,港澳客轮码头,出境,0,0,0,0
2020-03-01,屯门客运码头,入境,0,0,0,0
2020-03-01,屯门客运码头,出境,0,0,0,0
2020-03-02,机场,入境,10261,732,1935,12928
2020-03-02,机场,出境,6755,206,1314,8275
2020-03-02,高铁西九龙,入境,0,0,0,0
2020-03-02,高铁西九龙,出境,0,0,0,0
2020-03-02,红磡,入境,0,0,0,0
2020-03-02,红磡,出境,0,0,0,0
2020-03-02,罗湖,入境,0,0,0,0
2020-03-02,罗湖,出境,0,0,0,0
2020-03-02,落马洲支线,入境,0,0,0,0
2020-03-02,落马洲支线,出境,0,0,0,0
2020-03-02,港珠澳大桥,入境,4244,10,738,4992
2020-03-02,港珠澳大桥,出境,5321,93,836,6250
2020-03-02,落马洲,入境,0,0,0,0
2020-03-02,落马洲,出境,0,0,0,0
2020-03-02,文锦渡,入境,0,0,0,0
2020-03-02,文锦渡,出境,0,0,0,0
2020-03-02,沙头角,入境,0,0,0,0
2020-03-02,沙头角,出境,0,0,0,0
2020-03-02,深圳湾,入境,2124,231,9,2364
2020-03-02,深圳湾,出境,2551,924,655,4130
2020-03-02,中国客运码头,入境,0,0,0,0
2020-03-02,中国客运码头,出境,0,0,0,0
2020-03-02,港口管制,入境,0,0,0,0
2020-03-02,港口管制,出境,0,0,0,0
2020-03-02,启德邮轮码头,入境,0,0,0,0
2020-03-02,启德邮轮码头,出境,0,0,0,0
2020-03-02,港澳客轮码头,入境,0,0,0,0
2020-03-02,港澳客轮码头,出境,0,0,0,0
2020-03-02,屯门客运码头,入境,0,0,0,0
2020-03-02,屯门客运码头,出境,0,0,0,0
2020-03-03,机场,入境,7960,734,1923,10617
2020-03-03,机场,出境,6684,190,1349,8223
2020-03-03,高铁西九龙,入境,0,0,0,0
2020-03-03,高铁西九龙,出境,0,0,0,0
2020-03-03,红磡,入境,0,0,0,0
2020-03-03,红磡,出境,0,0,0,0
2020-03-03,罗湖,入境,0,0,0,0
2020-03-03,罗湖,出境,0,0,0,0
2020-03-03,落马洲支线,入境,0,0,0,0
2020-03-03,落马洲支线,出境,0,0,0,0
2020-03-03,港珠澳大桥,入境,4398,19,756,5173
2020-03-03,港珠澳大桥,出境,4798,117,780,5695
2020-03-03,落马洲,入境,0,0,0,0
2020-03-03,落马洲,出境,0,0,0,0
2020-03-03,文锦渡,入境,0,0,0,0
2020-03-03,文锦渡,出境,0,0,0,0
2020-03-03,沙头角,入境,0,0,0,0
2020-03-03,沙头角,出境,0,0,0,0
2020-03-03,深圳湾,入境,1479,165,3,1647
2020-03-03,深圳湾,出境,1970,793,667,3430
2020-03-03,中国客运码头,入境,0,0,0,0
2020-03-03,中国客运码头,出境,0,0,0,0
2020-03-03,港口管制,入境,0,0,0,0
2020-03-03,港口管制,出境,0,0,0,0
2020-03-03,启德邮轮码头,入境,0,0,0,0
2020-03-03,启德邮轮码头,出境,0,0,0,0
2020-03-03,港澳客轮码头,入境,0,0,0,0
2020-03-03,港澳客轮码头,出境,0,0,0,0
2020-03-03,屯门客运码头,入境,0,0,0,0
2020-03-03,屯门客运码头,出境,0,0,0,0
2020-03-04,机场,入境,7590,772,1847,10209
2020-03-04,机场,出境,7170,213,1123,8506
2020-03-04,高铁西九龙,入境,0,0,0,0
2020-03-04,高铁西九龙,出境,0,0,0,0
2020-03-04,红磡,入境,0,0,0,0
2020-03-04,红磡,出境,0,0,0,0
2020-03-04,罗湖,入境,0,0,0,0
2020-03-04,罗湖,出境,0,0,0,0
2020-03-04,落马洲支线,入境,0,0,0,0
2020-03-04,落马洲支线,出境,0,0,0,0
2020-03-04,港珠澳大桥,入境,4368,9,753,5130
2020-03-04,港珠澳大桥,出境,4539,92,802,5433
2020-03-04,落马洲,入境,0,0,0,0
2020-03-04,落马洲,出境,0,0,0,0
2020-03-04,文锦渡,入境,0,0,0,0
2020-03-04,文锦渡,出境,0,0,0,0
2020-03-04,沙头角,入境,0,0,0,0
2020-03-04,沙头角,出境,0,0,0,0
2020-03-04,深圳湾,入境,1306,192,7,1505
2020-03-04,深圳湾,出境,1684,806,664,3154
2020-03-04,中国客运码头,入境,0,0,0,0
2020-03-04,中国客运码头,出境,0,0,0,0
2020-03-04,港口管制,入境,0,0,0,0
2020-03-04,港口管制,出境,0,0,0,0
2020-03-04,启德邮轮码头,入境,0,0,0,0
2020-03-04,启德邮轮码头,出境,0,0,0,0
2020-03-04,港澳客轮码头,入境,0,0,0,0
2020-03-04,港澳客轮码头,出境,0,0,0,0
2020-03-04,屯门客运码头,入境,0,0,0,0
2020-03-04,屯门客运码头,出境,0,0,0,0
2020-03-05,机场,入境,7074,673,1749,9496
2020-03-05,机场,出境,8141,190,1289,9620
2020-03-05,高铁西九龙,入境,0,0,0,0
2020-03-05,高铁西九龙,出境,0,0,0,0
2020-03-05,红磡,入境,0,0,0,0
2020-03-05,红磡,出境,0,0,0,0
2020-03-05,罗湖,入境,0,0,0,0
2020-03-05,罗湖,出境,0,0,0,0
2020-03-05,落马洲支线,入境,0,0,0,0
2020-03-05,落马洲支线,出境,0,0,0,0
2020-03-05,港珠澳大桥,入境,4752,17,782,5551
2020-03-05,港珠澳大桥,出境,4999,96,776,5871
2020-03-05,落马洲,入境,0,0,0,0
2020-03-05,落马洲,出境,0,0,0,0
2020-03-05,文锦渡,入境,0,0,0,0
2020-03-05,文锦渡,出境,0,0,0,0
2020-03-05,沙头角,入境,0,0,0,0
2020-03-05,沙头角,出境,0,0,0,0
2020-03-05,深圳湾,入境,1419,226,3,1648
2020-03-05,深圳湾,出境,1589,767,638,2994
2020-03-05,中国客运码头,入境,0,0,0,0
2020-03-05,中国客运码头,出境,0,0,0,0
2020-03-05,港口管制,入境,0,0,0,0
2020-03-05,港口管制,出境,0,0,0,0
2020-03-05,启德邮轮码头,入境,0,0,0,0
2020-03-05,启德邮轮码头,出境,0,0,0,0
2020-03-05,港澳客轮码头,入境,0,0,0,0
2020-03-05,港澳客轮码头,出境,0,0,0,0
2020-03-05,屯门客运码头,入境,0,0,0,0
2020-03-05,屯门客运码头,出境,0,0,0,0
2020-03-06,机场,入境,7474,705,1877,10056
2020-03-06,机场,出境,8746,215,1150,10111
2020-03-06,高铁西九龙,入境,0,0,0,0
2020-03-06,高铁西九龙,出境,0,0,0,0
2020-03-06,红磡,入境,0,0,0,0
2020-03-06,红磡,出境,0,0,0,0
2020-03-06,罗湖,入境,0,0,0,0
2020-03-06,罗湖,出境,0,0,0,0
2020-03-06,落马洲支线,入境,0,0,0,0
2020-03-06,落马洲支线,出境,0,0,0,0
2020-03-06,港珠澳大桥,入境,6255,22,894,7171
2020-03-06,港珠澳大桥,出境,6030,116,768,6914
2020-03-06,落马洲,入境,0,0,0,0
2020-03-06,落马洲,出境,0,0,0,0
2020-03-06,文锦渡,入境,0,0,0,0
2020-03-06,文锦渡,出境,0,0,0,0
2020-03-06,沙头角,入境,0,0,0,0
2020-03-06,沙头角,出境,0,0,0,0
2020-03-06,深圳湾,入境,1425,251,8,1684
2020-03-06,深圳湾,出境,1550,734,544,2828
2020-03-06,中国客运码头,入境,0,0,0,0
2020-03-06,中国客运码头,出境,0,0,0,0
2020-03-06,港口管制,入境,0,0,0,0
2020-03-06,港口管制,出境,0,0,0,0
2020-03-06,启德邮轮码头,入境,0,0,0,0
2020-03-06,启德邮轮码头,出境,0,0,0,0
2020-03-06,港澳客轮码头,入境,0,0,0,0
2020-03-06,港澳客轮码头,出境,0,0,0,0
2020-03-06,屯门客运码头,入境,0,0,0,0
2020-03-06,屯门客运码头,出境,0,0,0,0
2020-03-07,机场,入境,8659,795,1919,11373
2020-03-07,机场,出境,7316,216,1398,8930
2020-03-07,高铁西九龙,入境,0,0,0,0
2020-03-07,高铁西九龙,出境,0,0,0,0
2020-03-07,红磡,入境,0,0,0,0
2020-03-07,红磡,出境,0,0,0,0
2020-03-07,罗湖,入境,0,0,0,0
2020-03-07,罗湖,出境,0,0,0,0
2020-03-07,落马洲支线,入境,0,0,0,0
2020-03-07,落马洲支线,出境,0,0,0,0
2020-03-07,港珠澳大桥,入境,5935,26,973,6934
2020-03-07,港珠澳大桥,出境,6440,132,903,7475
2020-03-07,落马洲,入境,0,0,0,0
2020-03-07,落马洲,出境,0,0,0,0
2020-03-07,文锦渡,入境,0,0,0,0
2020-03-07,文锦渡,出境,0,0,0,0
2020-03-07,沙头角,入境,0,0,0,0
2020-03-07,沙头角,出境,0,0,0,0
2020-03-07,深圳湾,入境,1180,269,2,1451
2020-03-07,深圳湾,出境,1380,856,622,2858
2020-03-07,中国客运码头,入境,0,0,0,0
2020-03-07,中国客运码头,出境,0,0,0,0
2020-03-07,港口管制,入境,0,0,0,0
2020-03-07,港口管制,出境,0,0,0,0
2020-03-07,启德邮轮码头,入境,0,0,0,0
2020-03-07,启德邮轮码头,出境,0,0,0,0
2020-03-07,港澳客轮码头,入境,0,0,0,0
2020-03-07,港澳客轮码头,出境,0,0,0,0
2020-03-07,屯门客运码头,入境,0,0,0,0
2020-03-07,屯门客运码头,出境,0,0,0,0
2020-03-08,机场,入境,12538,730,1833,15101
2020-03-08,机场,出境,6371,276,1376,8023
2020-03-08,高铁西九龙,入境,0,0,0,0
2020-03-08,高铁西九龙,出境,0,0,0,0
2020-03-08,红磡,入境,0,0,0,0
2020-03-08,红磡,出境,0,0,0,0
2020-03-08,罗湖,入境,0,0,0,0
2020-03-08,罗湖,出境,0,0,0,0
2020-03-08,落马洲支线,入境,0,0,0,0
2020-03-08,落马洲支线,出境,0,0,0,0
2020-03-08,港珠澳大桥,入境,6331,23,806,7160
2020-03-08,港珠澳大桥,出境,5935,109,1127,7171
2020-03-08,落马洲,入境,0,0,0,0
2020-03-08,落马洲,出境,0,0,0,0
2020-03-08,文锦渡,入境,0,0,0,0
2020-03-08,文锦渡,出境,0,0,0,0
2020-03-08,沙头角,入境,0,0,0,0
2020-03-08,沙头角,出境,0,0,0,0
2020-03-08,深圳湾,入境,1386,252,9,1647
2020-03-08,深圳湾,出境,1547,897,678,3122
2020-03-08,中国客运码头,入境,0,0,0,0
2020-03-08,中国客运码头,出境,0,0,0,0
2020-03-08,港口管制,入境,0,0,0,0
2020-03-08,港口管制,出境,0,0,0,0
2020-03-08,启德邮轮码头,入境,0,0,0,0
2020-03-08,启德邮轮码头,出境,0,0,0,0
2020-03-08,港澳客轮码头,入境,0,0,0,0
2020-03-08,港澳客轮码头,出境,0,0,0,0
2020-03-08,屯门客运码头,入境,0,0,0,0
2020-03-08,屯门客运码头,出境,0,0,0,0
2020-03-09,机场,入境,8304,706,1623,10633
2020-03-09,机场,出境,4721,139,970,5830
2020-03-09,高铁西九龙,入境,0,0,0,0
2020-03-09,高铁西九龙,出境,0,0,0,0
2020-03-09,红磡,入境,0,0,0,0
2020-03-09,红磡,出境,0,0,0,0
2020-03-09,罗湖,入境,0,0,0,0
2020-03-09,罗湖,出境,0,0,0,0
2020-03-09,落马洲支线,入境,0,0,0,0
2020-03-09,落马洲支线,出境,0,0,0,0
2020-03-09,港珠澳大桥,入境,5638,16,805,6459
2020-03-09,港珠澳大桥,出境,6224,133,929,7286
2020-03-09,落马洲,入境,0,0,0,0
2020-03-09,落马洲,出境,0,0,0,0
2020-03-09,文锦渡,入境,0,0,0,0
2020-03-09,文锦渡,出境,0,0,0,0
2020-03-09,沙头角,入境,0,0,0,0
2020-03-09,沙头角,出境,0,0,0,0
2020-03-09,深圳湾,入境,1632,233,10,1875
2020-03-09,深圳湾,出境,2197,774,592,3563
2020-03-09,中国客运码头,入境,0,0,0,0
2020-03-09,中国客运码头,出境,0,0,0,0
2020-03-09,港口管制,入境,0,0,0,0
2020-03-09,港口管制,出境,0,0,0,0
2020-03-09,启德邮轮码头,入境,0,0,0,0
2020-03-09,启德邮轮码头,出境,0,0,0,0
2020-03-09,港澳客轮码头,入境,0,0,0,0
2020-03-09,港澳客轮码头,出境,0,0,0,0
2020-03-09,屯门客运码头,入境,0,0,0,0
2020-03-09,屯门客运码头,出境,0,0,0,0
2020-03-10,机场,入境,7051,663,1531,9245
2020-03-10,机场,出境,3802,142,914,4858
2020-03-10,高铁西九龙,入境,0,0,0,0
2020-03-10,高铁西九龙,出境,0,0,0,0
2020-03-10,红磡,入境,0,0,0,0
2020-03-10,红磡,出境,0,0,0,0
2020-03-10,罗湖,入境,0,0,0,0
2020-03-10,罗湖,出境,0,0,0,0
2020-03-10,落马洲支线,入境,0,0,0,0
2020-03-10,落马洲支线,出境,0,0,0,0
2020-03-10,港珠澳大桥,入境,5366,31,757,6154
2020-03-10,港珠澳大桥,出境,5687,84,900,6671
2020-03-10,落马洲,入境,0,0,0,0
2020-03-10,落马洲,出境,0,0,0,0
2020-03-10,文锦渡,入境,0,0,0,0
2020-03-10,文锦渡,出境,0,0,0,0
2020-03-10,沙头角,入境,0,0,0,0
2020-03-10,沙头角,出境,0,0,0,0
2020-03-10,深圳湾,入境,1491,212,5,1708
2020-03-10,深圳湾,出境,1762,802,432,2996
2020-03-10,中国客运码头,入境,0,0,0,0
2020-03-10,中国客运码头,出境,0,0,0,0
2020-03-10,港口管制,入境,0,0,0,0
2020-03-10,港口管制,出境,0,0,0,0
2020-03-10,启德邮轮码头,入境,0,0,0,0
2020-03-10,启德邮轮码头,出境,0,0,0,0
2020-03-10,港澳客轮码头,入境,0,0,0,0
2020-03-10,港澳客轮码头,出境,0,0,0,0
2020-03-10,屯门客运码头,入境,0,0,0,0
2020-03-10,屯门客运码头,出境,0,0,0,0
2020-03-11,机场,入境,7610,838,1539,9987
2020-03-11,机场,出境,3443,205,841,4489
2020-03-11,高铁西九龙,入境,0,0,0,0
2020-03-11,高铁西九龙,出境,0,0,0,0
2020-03-11,红磡,入境,0,0,0,0
2020-03-11,红磡,出境,0,0,0,0
2020-03-11,罗湖,入境,0,0,0,0
2020-03-11,罗湖,出境,0,0,0,0
2020-03-11,落马洲支线,入境,0,0,0,0
2020-03-11,落马洲支线,出境,0,0,0,0
2020-03-11,港珠澳大桥,入境,5248,25,733,6006
2020-03-11,港珠澳大桥,出境,5258,122,765,6145
2020-03-11,落马洲,入境,0,0,0,0
2020-03-11,落马洲,出境,0,0,0,0
2020-03-11,文锦渡,入境,0,0,0,0
2020-03-11,文锦渡,出境,0,0,0,0
2020-03-11,沙头角,入境,0,0,0,0
2020-03-11,沙头角,出境,0,0,0,0
2020-03-11,深圳湾,入境,1418,244,2,1664
2020-03-11,深圳湾,出境,1632,866,443,2941
2020-03-11,中国客运码头,入境,0,0,0,0
2020-03-11,中国客运码头,出境,0,0,0,0
2020-03-11,港口管制,入境,0,0,0,0
2020-03-11,港口管制,出境,0,0,0,0
2020-03-11,启德邮轮码头,入境,0,0,0,0
2020-03-11,启德邮轮码头,出境,0,0,0,0
2020-03-11,港澳客轮码头,入境,0,0,0,0
2020-03-11,港澳客轮码头,出境,0,0,0,0
2020-03-11,屯门客运码头,入境,0,0,0,0
2020-03-11,屯门客运码头,出境,0,0,0,0
2020-03-12,机场,入境,6416,944,1426,8786
2020-03-12,机场,出境,4050,152,995,5197
2020-03-12,高铁西九龙,入境,0,0,0,0
2020-03-12,高铁西九龙,出境,0,0,0,0
2020-03-12,红磡,入境,0,0,0,0
2020-03-12,红磡,出境,0,0,0,0
2020-03-12,罗湖,入境,0,0,0,0
2020-03-12,罗湖,出境,0,0,0,0
2020-03-12,落马洲支线,入境,0,0,0,0
2020-03-12,落马洲支线,出境,0,0,0,0
2020-03-12,港珠澳大桥,入境,5391,21,753,6165
2020-03-12,港珠澳大桥,出境,5753,177,790,6720
2020-03-12,落马洲,入境,0,0,0,0
2020-03-12,落马洲,出境,0,0,0,0
2020-03-12,文锦渡,入境,0,0,0,0
2020-03-12,文锦渡,出境,0,0,0,0
2020-03-12,沙头角,入境,0,0,0,0
2020-03-12,沙头角,出境,0,0,0,0
2020-03-12,深圳湾,入境,1376,235,3,1614
2020-03-12,深圳湾,出境,1602,887,417,2906
2020-03-12,中国客运码头,入境,0,0,0,0
2020-03-12,中国客运码头,出境,0,0,0,0
2020-03-12,港口管制,入境,0,0,0,0
2020-03-12,港口管制,出境,0,0,0,0
2020-03-12,启德邮轮码头,入境,0,0,0,0
2020-03-12,启德邮轮码头,出境,0,0,0,0
2020-03-12,港澳客轮码头,入境,0,0,0,0
2020-03-12,港澳客轮码头,出境,0,0,0,0
2020-03-12,屯门客运码头,入境,0,0,0,0
2020-03-12,屯门客运码头,出境,0,0,0,0
2020-03-13,机场,入境,6758,1075,1401,9234
2020-03-13,机场,出境,4435,269,1044,5748
2020-03-13,高铁西九龙,入境,0,0,0,0
2020-03-13,高铁西九龙,出境,0,0,0,0
2020-03-13,红磡,入境,0,0,0,0
2020-03-13,红磡,出境,0,0,0,0
2020-03-13,罗湖,入境,0,0,0,0
2020-03-13,罗湖,出境,0,0,0,0
2020-03-13,落马洲支线,入境,0,0,0,0
2020-03-13,落马洲支线,出境,0,0,0,0
2020-03-13,港珠澳大桥,入境,6872,19,945,7836
2020-03-13,港珠澳大桥,出境,6694,142,939,7775
2020-03-13,落马洲,入境,0,0,0,0
2020-03-13,落马洲,出境,0,0,0,0
2020-03-13,文锦渡,入境,0,0,0,0
2020-03-13,文锦渡,出境,0,0,0,0
2020-03-13,沙头角,入境,0,0,0,0
2020-03-13,沙头角,出境,0,0,0,0
2020-03-13,深圳湾,入境,1418,254,3,1675
2020-03-13,深圳湾,出境,1520,1018,369,2907
2020-03-13,中国客运码头,入境,0,0,0,0
2020-03-13,中国客运码头,出境,0,0,0,0
2020-03-13,港口管制,入境,0,0,0,0
2020-03-13,港口管制,出境,0,0,0,0
2020-03-13,启德邮轮码头,入境,0,0,0,0
2020-03-13,启德邮轮码头,出境,0,0,0,0
2020-03-13,港澳客轮码头,入境,0,0,0,0
2020-03-13,港澳客轮码头,出境,0,0,0,0
2020-03-13,屯门客运码头,入境,0,0,0,0
2020-03-13,屯门客运码头,出境,0,0,0,0
2020-03-14,机场,入境,7513,1435,1587,10535
2020-03-14,机场,出境,3764,214,996,4974
2020-03-14,高铁西九龙,入境,0,0,0,0
2020-03-14,高铁西九龙,出境,0,0,0,0
2020-03-14,红磡,入境,0,0,0,0
2020-03-14,红磡,出境,0,0,0,0
2020-03-14,罗湖,入境,0,0,0,0
2020-03-14,罗湖,出境,0,0,0,0
2020-03-14,落马洲支线,入境,0,0,0,0
2020-03-14,落马洲支线,出境,0,0,0,0
2020-03-14,港珠澳大桥,入境,6098,25,1075,7198
2020-03-14,港珠澳大桥,出境,7110,206,1126,8442
2020-03-14,落马洲,入境,0,0,0,0
2020-03-14,落马洲,出境,0,0,0,0
2020-03-14,文锦渡,入境,0,0,0,0
2020-03-14,文锦渡,出境,0,0,0,0
2020-03-14,沙头角,入境,0,0,0,0
2020-03-14,沙头角,出境,0,0,0,0
2020-03-14,深圳湾,入境,1276,270,3,1549
2020-03-14,深圳湾,出境,1560,1303,406,3269
2020-03-14,中国客运码头,入境,0,0,0,0
2020-03-14,中国客运码头,出境,0,0,0,0
2020-03-14,港口管制,入境,0,0,0,0
2020-03-14,港口管制,出境,0,0,0,0
2020-03-14,启德邮轮码头,入境,0,0,0,0
2020-03-14,启德邮轮码头,出境,0,0,0,0
2020-03-14,港澳客轮码头,入境,0,0,0,0
2020-03-14,港澳客轮码头,出境,0,0,0,0
2020-03-14,屯门客运码头,入境,0,0,0,0
2020-03-14,屯门客运码头,出境,0,0,0,0
2020-03-15,机场,入境,10027,1558,1950,13535
2020-03-15,机场,出境,2516,315,863,3694
2020-03-15,高铁西九龙,入境,0,0,0,0
2020-03-15,高铁西九龙,出境,0,0,0,0
2020-03-15,红磡,入境,0,0,0,0
2020-03-15,红磡,出境,0,0,0,0
2020-03-15,罗湖,入境,0,0,0,0
2020-03-15,罗湖,出境,0,0,0,0
2020-03-15,落马洲支线,入境,0,0,0,0
2020-03-15,落马洲支线,出境,0,0,0,0
2020-03-15,港珠澳大桥,入境,8172,33,674,8879
2020-03-15,港珠澳大桥,出境,7405,194,1233,8832
2020-03-15,落马洲,入境,0,0,0,0
2020-03-15,落马洲,出境,0,0,0,0
2020-03-15,文锦渡,入境,0,0,0,0
2020-03-15,文锦渡,出境,0,0,0,0
2020-03-15,沙头角,入境,0,0,0,0
2020-03-15,沙头角,出境,0,0,0,0
2020-03-15,深圳湾,入境,1745,351,18,2114
2020-03-15,深圳湾,出境,1628,1565,632,3825
2020-03-15,中国客运码头,入境,0,0,0,0
2020-03-15,中国客运码头,出境,0,0,0,0
2020-03-15,港口管制,入境,0,0,0,0
2020-03-15,港口管制,出境,0,0,0,0
2020-03-15,启德邮轮码头,入境,0,0,0,0
2020-03-15,启德邮轮码头,出境,0,0,0,0
2020-03-15,港澳客轮码头,入境,0,0,0,0
2020-03-15,港澳客轮码头,出境,0,0,0,0
2020-03-15,屯门客运码头,入境,0,0,0,0
2020-03-15,屯门客运码头,出境,0,0,0,0
2020-03-16,机场,入境,8498,1662,2038,12198
2020-03-16,机场,出境,2117,382,896,3395
2020-03-16,高铁西九龙,入境,0,0,0,0
2020-03-16,高铁西九龙,出境,0,0,0,0
2020-03-16,红磡,入境,0,0,0,0
2020-03-16,红磡,出境,0,0,0,0
2020-03-16,罗湖,入境,0,0,0,0
2020-03-16,罗湖,出境,0,0,0,0
2020-03-16,落马洲支线,入境,0,0,0,0
2020-03-16,落马洲支线,出境,0,0,0,0
2020-03-16,港珠澳大桥,入境,6258,28,792,7078
2020-03-16,港珠澳大桥,出境,6782,314,1408,8504
2020-03-16,落马洲,入境,0,0,0,0
2020-03-16,落马洲,出境,0,0,0,0
2020-03-16,文锦渡,入境,0,0,0,0
2020-03-16,文锦渡,出境,0,0,0,0
2020-03-16,沙头角,入境,0,0,0,0
2020-03-16,沙头角,出境,0,0,0,0
2020-03-16,深圳湾,入境,1878,326,8,2212
2020-03-16,深圳湾,出境,2182,1450,593,4225
2020-03-16,中国客运码头,入境,0,0,0,0
2020-03-16,中国客运码头,出境,0,0,0,0
2020-03-16,港口管制,入境,0,0,0,0
2020-03-16,港口管制,出境,0,0,0,0
2020-03-16,启德邮轮码头,入境,0,0,0,0
2020-03-16,启德邮轮码头,出境,0,0,0,0
2020-03-16,港澳客轮码头,入境,0,0,0,0
2020-03-16,港澳客轮码头,出境,0,0,0,0
2020-03-16,屯门客运码头,入境,0,0,0,0
2020-03-16,屯门客运码头,出境,0,0,0,0
2020-03-17,机场,入境,7472,1702,1272,10446
2020-03-17,机场,出境,1483,339,666,2488
2020-03-17,高铁西九龙,入境,0,0,0,0
2020-03-17,高铁西九龙,出境,0,0,0,0
2020-03-17,红磡,入境,0,0,0,0
2020-03-17,红磡,出境,0,0,0,0
2020-03-17,罗湖,入境,0,0,0,0
2020-03-17,罗湖,出境,0,0,0,0
2020-03-17,落马洲支线,入境,0,0,0,0
2020-03-17,落马洲支线,出境,0,0,0,0
2020-03-17,港珠澳大桥,入境,5812,21,753,6586
2020-03-17,港珠澳大桥,出境,5791,287,979,7057
2020-03-17,落马洲,入境,0,0,0,0
2020-03-17,落马洲,出境,0,0,0,0
2020-03-17,文锦渡,入境,0,0,0,0
2020-03-17,文锦渡,出境,0,0,0,0
2020-03-17,沙头角,入境,0,0,0,0
2020-03-17,沙头角,出境,0,0,0,0
2020-03-17,深圳湾,入境,1393,257,4,1654
2020-03-17,深圳湾,出境,1672,1420,446,3538
2020-03-17,中国客运码头,入境,0,0,0,0
2020-03-17,中国客运码头,出境,0,0,0,0
2020-03-17,港口管制,入境,0,0,0,0
2020-03-17,港口管制,出境,0,0,0,0
2020-03-17,启德邮轮码头,入境,0,0,0,0
2020-03-17,启德邮轮码头,出境,0,0,0,0
2020-03-17,港澳客轮码头,入境,0,0,0,0
2020-03-17,港澳客轮码头,出境,0,0,0,0
2020-03-17,屯门客运码头,入境,0,0,0,0
2020-03-17,屯门客运码头,出境,0,0,0,0
2020-03-18,机场,入境,9616,2027,1309,12952
2020-03-18,机场,出境,1041,337,615,1993
2020-03-18,高铁西九龙,入境,0,0,0,0
2020-03-18,高铁西九龙,出境,0,0,0,0
2020-03-18,红磡,入境,0,0,0,0
2020-03-18,红磡,出境,0,0,0,0
2020-03-18,罗湖,入境,0,0,0,0
2020-03-18,罗湖,出境,0,0,0,0
2020-03-18,落马洲支线,入境,0,0,0,0
2020-03-18,落马洲支线,出境,0,0,0,0
2020-03-18,港珠澳大桥,入境,5266,37,580,5883
2020-03-18,港珠澳大桥,出境,4850,334,792,5976
2020-03-18,落马洲,入境,0,0,0,0
2020-03-18,落马洲,出境,0,0,0,0
2020-03-18,文锦渡,入境,0,0,0,0
2020-03-18,文锦渡,出境,0,0,0,0
2020-03-18,沙头角,入境,0,0,0,0
2020-03-18,沙头角,出境,0,0,0,0
2020-03-18,深圳湾,入境,1394,344,10,1748
2020-03-18,深圳湾,出境,1570,1734,360,3664
2020-03-18,中国客运码头,入境,0,0,0,0
2020-03-18,中国客运码头,出境,0,0,0,0
2020-03-18,港口管制,入境,0,0,0,0
2020-03-18,港口管制,出境,0,0,0,0
2020-03-18,启德邮轮码头,入境,0,0,0,0
2020-03-18,启德邮轮码头,出境,0,0,0,0
2020-03-18,港澳客轮码头,入境,0,0,0,0
2020-03-18,港澳客轮码头,出境,0,0,0,0
2020-03-18,屯门客运码头,入境,0,0,0,0
2020-03-18,屯门客运码头,出境,0,0,0,0
2020-03-19,机场,入境,6138,37,596,6771
2020-03-19,机场,出境,1110,160,519,1789
2020-03-19,高铁西九龙,入境,0,0,0,0
2020-03-19,高铁西九龙,出境,0,0,0,0
2020-03-19,红磡,入境,0,0,0,0
2020-03-19,红磡,出境,0,0,0,0
2020-03-19,罗湖,入境,0,0,0,0
2020-03-19,罗湖,出境,0,0,0,0
2020-03-19,落马洲支线,入境,0,0,0,0
2020-03-19,落马洲支线,出境,0,0,0,0
2020-03-19,港珠澳大桥,入境,4687,22,352,5061
2020-03-19,港珠澳大桥,出境,4824,46,423,5293
2020-03-19,落马洲,入境,0,0,0,0
2020-03-19,落马洲,出境,0,0,0,0
2020-03-19,文锦渡,入境,0,0,0,0
2020-03-19,文锦渡,出境,0,0,0,0
2020-03-19,沙头角,入境,0,0,0,0
2020-03-19,沙头角,出境,0,0,0,0
2020-03-19,深圳湾,入境,1099,184,3,1286
2020-03-19,深圳湾,出境,1449,458,244,2151
2020-03-19,中国客运码头,入境,0,0,0,0
2020-03-19,中国客运码头,出境,0,0,0,0
2020-03-19,港口管制,入境,0,0,0,0
2020-03-19,港口管制,出境,0,0,0,0
2020-03-19,启德邮轮码头,入境,0,0,0,0
2020-03-19,启德邮轮码头,出境,0,0,0,0
2020-03-19,港澳客轮码头,入境,0,0,0,0
2020-03-19,港澳客轮码头,出境,0,0,0,0
2020-03-19,屯门客运码头,入境,0,0,0,0
2020-03-19,屯门客运码头,出境,0,0,0,0
2020-03-20,机场,入境,6427,44,603,7074
2020-03-20,机场,出境,1190,54,445,1689
2020-03-20,高铁西九龙,入境,0,0,0,0
2020-03-20,高铁西九龙,出境,0,0,0,0
2020-03-20,红磡,入境,0,0,0,0
2020-03-20,红磡,出境,0,0,0,0
2020-03-20,罗湖,入境,0,0,0,0
2020-03-20,罗湖,出境,0,0,0,0
2020-03-20,落马洲支线,入境,0,0,0,0
2020-03-20,落马洲支线,出境,0,0,0,0
2020-03-20,港珠澳大桥,入境,5732,18,458,6208
2020-03-20,港珠澳大桥,出境,5426,48,691,6165
2020-03-20,落马洲,入境,0,0,0,0
2020-03-20,落马洲,出境,0,0,0,0
2020-03-20,文锦渡,入境,0,0,0,0
2020-03-20,文锦渡,出境,0,0,0,0
2020-03-20,沙头角,入境,0,0,0,0
2020-03-20,沙头角,出境,0,0,0,0
2020-03-20,深圳湾,入境,1328,245,3,1576
2020-03-20,深圳湾,出境,1404,401,176,1981
2020-03-20,中国客运码头,入境,0,0,0,0
2020-03-20,中国客运码头,出境,0,0,0,0
2020-03-20,港口管制,入境,0,0,0,0
2020-03-20,港口管制,出境,0,0,0,0
2020-03-20,启德邮轮码头,入境,0,0,0,0
2020-03-20,启德邮轮码头,出境,0,0,0,0
2020-03-20,港澳客轮码头,入境,0,0,0,0
2020-03-20,港澳客轮码头,出境,0,0,0,0
2020-03-20,屯门客运码头,入境,0,0,0,0
2020-03-20,屯门客运码头,出境,0,0,0,0
2020-03-21,机场,入境,6547,43,526,7116
2020-03-21,机场,出境,844,39,320,1203
2020-03-21,高铁西九龙,入境,0,0,0,0
2020-03-21,高铁西九龙,出境,0,0,0,0
2020-03-21,红磡,入境,0,0,0,0
2020-03-21,红磡,出境,0,0,0,0
2020-03-21,罗湖,入境,0,0,0,0
2020-03-21,罗湖,出境,0,0,0,0
2020-03-21,落马洲支线,入境,0,0,0,0
2020-03-21,落马洲支线,出境,0,0,0,0
2020-03-21,港珠澳大桥,入境,4805,37,388,5230
2020-03-21,港珠澳大桥,出境,5244,70,536,5850
2020-03-21,落马洲,入境,0,0,0,0
2020-03-21,落马洲,出境,0,0,0,0
2020-03-21,文锦渡,入境,0,0,0,0
2020-03-21,文锦渡,出境,0,0,0,0
2020-03-21,沙头角,入境,0,0,0,0
2020-03-21,沙头角,出境,0,0,0,0
2020-03-21,深圳湾,入境,904,239,5,1148
2020-03-21,深圳湾,出境,1384,457,113,1954
2020-03-21,中国客运码头,入境,0,0,0,0
2020-03-21,中国客运码头,出境,0,0,0,0
2020-03-21,港口管制,入境,0,0,0,0
2020-03-21,港口管制,出境,0,0,0,0
2020-03-21,启德邮轮码头,入境,0,0,0,0
2020-03-21,启德邮轮码头,出境,0,0,0,0
2020-03-21,港澳客轮码头,入境,0,0,0,0
2020-03-21,港澳客轮码头,出境,0,0,0,0
2020-03-21,屯门客运码头,入境,0,0,0,0
2020-03-21,屯门客运码头,出境,0,0,0,0
2020-03-22,机场,入境,5596,33,566,6195
2020-03-22,机场,出境,659,49,228,936
2020-03-22,高铁西九龙,入境,0,0,0,0
2020-03-22,高铁西九龙,出境,0,0,0,0
2020-03-22,红磡,入境,0,0,0,0
2020-03-22,红磡,出境,0,0,0,0
2020-03-22,罗湖,入境,0,0,0,0
2020-03-22,罗湖,出境,0,0,0,0
2020-03-22,落马洲支线,入境,0,0,0,0
2020-03-22,落马洲支线,出境,0,0,0,0
2020-03-22,港珠澳大桥,入境,4996,31,235,5262
2020-03-22,港珠澳大桥,出境,4386,49,453,4888
2020-03-22,落马洲,入境,0,0,0,0
2020-03-22,落马洲,出境,0,0,0,0
2020-03-22,文锦渡,入境,0,0,0,0
2020-03-22,文锦渡,出境,0,0,0,0
2020-03-22,沙头角,入境,0,0,0,0
2020-03-22,沙头角,出境,0,0,0,0
2020-03-22,深圳湾,入境,1064,272,4,1340
2020-03-22,深圳湾,出境,1619,567,199,2385
2020-03-22,中国客运码头,入境,0,0,0,0
2020-03-22,中国客运码头,出境,0,0,0,0
2020-03-22,港口管制,入境,0,0,0,0
2020-03-22,港口管制,出境,0,0,0,0
2020-03-22,启德邮轮码头,入境,0,0,0,0
2020-03-22,启德邮轮码头,出境,0,0,0,0
2020-03-22,港澳客轮码头,入境,0,0,0,0
2020-03-22,港澳客轮码头,出境,0,0,0,0
2020-03-22,屯门客运码头,入境,0,0,0,0
2020-03-22,屯门客运码头,出境,0,0,0,0
2020-03-23,机场,入境,4536,30,529,5095
2020-03-23,机场,出境,514,34,208,756
2020-03-23,高铁西九龙,入境,0,0,0,0
2020-03-23,高铁西九龙,出境,0,0,0,0
2020-03-23,红磡,入境,0,0,0,0
2020-03-23,红磡,出境,0,0,0,0
2020-03-23,罗湖,入境,0,0,0,0
2020-03-23,罗湖,出境,0,0,0,0
2020-03-23,落马洲支线,入境,0,0,0,0
2020-03-23,落马洲支线,出境,0,0,0,0
2020-03-23,港珠澳大桥,入境,4930,16,353,5299
2020-03-23,港珠澳大桥,出境,5722,43,539,6304
2020-03-23,落马洲,入境,0,0,0,0
2020-03-23,落马洲,出境,0,0,0,0
2020-03-23,文锦渡,入境,0,0,0,0
2020-03-23,文锦渡,出境,0,0,0,0
2020-03-23,沙头角,入境,0,0,0,0
2020-03-23,沙头角,出境,0,0,0,0
2020-03-23,深圳湾,入境,1053,201,4,1258
2020-03-23,深圳湾,出境,2229,462,207,2898
2020-03-23,中国客运码头,入境,0,0,0,0
2020-03-23,中国客运码头,出境,0,0,0,0
2020-03-23,港口管制,入境,0,0,0,0
2020-03-23,港口管制,出境,0,0,0,0
2020-03-23,启德邮轮码头,入境,0,0,0,0
2020-03-23,启德邮轮码头,出境,0,0,0,0
2020-03-23,港澳客轮码头,入境,0,0,0,0
2020-03-23,港澳客轮码头,出境,0,0,0,0
2020-03-23,屯门客运码头,入境,0,0,0,0
2020-03-23,屯门客运码头,出境,0,0,0,0
2020-03-24,机场,入境,3488,73,855,4416
2020-03-24,机场,出境,577,21,260,858
2020-03-24,高铁西九龙,入境,0,0,0,0
2020-03-24,高铁西九龙,出境,0,0,0,0
2020-03-24,红磡,入境,0,0,0,0
2020-03-24,红磡,出境,0,0,0,0
2020-03-24,罗湖,入境,0,0,0,0
2020-03-24,罗湖,出境,0,0,0,0
2020-03-24,落马洲支线,入境,0,0,0,0
2020-03-24,落马洲支线,出境,0,0,0,0
2020-03-24,港珠澳大桥,入境,7851,47,942,8840
2020-03-24,港珠澳大桥,出境,6050,67,1082,7199
2020-03-24,落马洲,入境,0,0,0,0
2020-03-24,落马洲,出境,0,0,0,0
2020-03-24,文锦渡,入境,0,0,0,0
2020-03-24,文锦渡,出境,0,0,0,0
2020-03-24,沙头角,入境,0,0,0,0
2020-03-24,沙头角,出境,0,0,0,0
2020-03-24,深圳湾,入境,1198,317,12,1527
2020-03-24,深圳湾,出境,1793,453,401,2647
2020-03-24,中国客运码头,入境,0,0,0,0
2020-03-24,中国客运码头,出境,0,0,0,0
2020-03-24,港口管制,入境,0,0,0,0
2020-03-24,港口管制,出境,0,0,0,0
2020-03-24,启德邮轮码头,入境,0,0,0,0
2020-03-24,启德邮轮码头,出境,0,0,0,0
2020-03-24,港澳客轮码头,入境,0,0,0,0
2020-03-24,港澳客轮码头,出境,0,0,0,0
2020-03-24,屯门客运码头,入境,0,0,0,0
2020-03-24,屯门客运码头,出境,0,0,0,0
2020-03-25,机场,入境,4053,6,158,4217
2020-03-25,机场,出境,629,21,236,886
2020-03-25,高铁西九龙,入境,0,0,0,0
2020-03-25,高铁西九龙,出境,0,0,0,0
2020-03-25,红磡,入境,0,0,0,0
2020-03-25,红磡,出境,0,0,0,0
2020-03-25,罗湖,入境,0,0,0,0
2020-03-25,罗湖,出境,0,0,0,0
2020-03-25,落马洲支线,入境,0,0,0,0
2020-03-25,落马洲支线,出境,0,0,0,0
2020-03-25,港珠澳大桥,入境,106,7,19,132
2020-03-25,港珠澳大桥,出境,212,25,173,410
2020-03-25,落马洲,入境,0,0,0,0
2020-03-25,落马洲,出境,0,0,0,0
2020-03-25,文锦渡,入境,0,0,0,0
2020-03-25,文锦渡,出境,0,0,0,0
2020-03-25,沙头角,入境,0,0,0,0
2020-03-25,沙头角,出境,0,0,0,0
2020-03-25,深圳湾,入境,810,135,3,948
2020-03-25,深圳湾,出境,1525,326,21,1872
2020-03-25,中国客运码头,入境,0,0,0,0
2020-03-25,中国客运码头,出境,0,0,0,0
2020-03-25,港口管制,入境,0,0,0,0
2020-03-25,港口管制,出境,0,0,0,0
2020-03-25,启德邮轮码头,入境,0,0,0,0
2020-03-25,启德邮轮码头,出境,0,0,0,0
2020-03-25,港澳客轮码头,入境,0,0,0,0
2020-03-25,港澳客轮码头,出境,0,0,0,0
2020-03-25,屯门客运码头,入境,0,0,0,0
2020-03-25,屯门客运码头,出境,0,0,0,0
2020-03-26,机场,入境,3303,6,126,3435
2020-03-26,机场,出境,436,20,138,594
2020-03-26,高铁西九龙,入境,0,0,0,0
2020-03-26,高铁西九龙,出境,0,0,0,0
2020-03-26,红磡,入境,0,0,0,0
2020-03-26,红磡,出境,0,0,0,0
2020-03-26,罗湖,入境,0,0,0,0
2020-03-26,罗湖,出境,0,0,0,0
2020-03-26,落马洲支线,入境,0,0,0,0
2020-03-26,落马洲支线,出境,0,0,0,0
2020-03-26,港珠澳大桥,入境,95,8,23,126
2020-03-26,港珠澳大桥,出境,342,42,113,497
2020-03-26,落马洲,入境,0,0,0,0
2020-03-26,落马洲,出境,0,0,0,0
2020-03-26,文锦渡,入境,0,0,0,0
2020-03-26,文锦渡,出境,0,0,0,0
2020-03-26,沙头角,入境,0,0,0,0
2020-03-26,沙头角,出境,0,0,0,0
2020-03-26,深圳湾,入境,773,122,2,897
2020-03-26,深圳湾,出境,2476,522,16,3014
2020-03-26,中国客运码头,入境,0,0,0,0
2020-03-26,中国客运码头,出境,0,0,0,0
2020-03-26,港口管制,入境,0,0,0,0
2020-03-26,港口管制,出境,0,0,0,0
2020-03-26,启德邮轮码头,入境,0,0,0,0
2020-03-26,启德邮轮码头,出境,0,0,0,0
2020-03-26,港澳客轮码头,入境,0,0,0,0
2020-03-26,港澳客轮码头,出境,0,0,0,0
2020-03-26,屯门客运码头,入境,0,0,0,0
2020-03-26,屯门客运码头,出境,0,0,0,0
2020-03-27,机场,入境,2903,4,178,3085
2020-03-27,机场,出境,1030,46,238,1314
2020-03-27,高铁西九龙,入境,0,0,0,0
2020-03-27,高铁西九龙,出境,0,0,0,0
2020-03-27,红磡,入境,0,0,0,0
2020-03-27,红磡,出境,0,0,0,0
2020-03-27,罗湖,入境,0,0,0,0
2020-03-27,罗湖,出境,0,0,0,0
2020-03-27,落马洲支线,入境,0,0,0,0
2020-03-27,落马洲支线,出境,0,0,0,0
2020-03-27,港珠澳大桥,入境,124,9,17,150
2020-03-27,港珠澳大桥,出境,697,120,170,987
2020-03-27,落马洲,入境,0,0,0,0
2020-03-27,落马洲,出境,0,0,0,0
2020-03-27,文锦渡,入境,0,0,0,0
2020-03-27,文锦渡,出境,0,0,0,0
2020-03-27,沙头角,入境,0,0,0,0
2020-03-27,沙头角,出境,0,0,0,0
2020-03-27,深圳湾,入境,676,121,1,798
2020-03-27,深圳湾,出境,298,83,113,494
2020-03-27,中国客运码头,入境,0,0,0,0
2020-03-27,中国客运码头,出境,0,0,0,0
2020-03-27,港口管制,入境,0,0,0,0
2020-03-27,港口管制,出境,0,0,0,0
2020-03-27,启德邮轮码头,入境,0,0,0,0
2020-03-27,启德邮轮码头,出境,0,0,0,0
2020-03-27,港澳客轮码头,入境,0,0,0,0
2020-03-27,港澳客轮码头,出境,0,0,0,0
2020-03-27,屯门客运码头,入境,0,0,0,0
2020-03-27,屯门客运码头,出境,0,0,0,0
2020-03-28,机场,入境,3744,7,175,3926
2020-03-28,机场,出境,691,51,162,904
2020-03-28,高铁西九龙,入境,0,0,0,0
2020-03-28,高铁西九龙,出境,0,0,0,0
2020-03-28,红磡,入境,0,0,0,0
2020-03-28,红磡,出境,0,0,0,0
2020-03-28,罗湖,入境,0,0,0,0
2020-03-28,罗湖,出境,0,0,0,0
2020-03-28,落马洲支线,入境,0,0,0,0
2020-03-28,落马洲支线,出境,0,0,0,0
2020-03-28,港珠澳大桥,入境,67,7,16,90
2020-03-28,港珠澳大桥,出境,45,3,146,194
2020-03-28,落马洲,入境,0,0,0,0
2020-03-28,落马洲,出境,0,0,0,0
2020-03-28,文锦渡,入境,0,0,0,0
2020-03-28,文锦渡,出境,0,0,0,0
2020-03-28,沙头角,入境,0,0,0,0
2020-03-28,沙头角,出境,0,0,0,0
2020-03-28,深圳湾,入境,545,96,5,646
2020-03-28,深圳湾,出境,238,102,3,343
2020-03-28,中国客运码头,入境,0,0,0,0
2020-03-28,中国客运码头,出境,0,0,0,0
2020-03-28,港口管制,入境,0,0,0,0
2020-03-28,港口管制,出境,0,0,0,0
2020-03-28,启德邮轮码头,入境,0,0,0,0
2020-03-28,启德邮轮码头,出境,0,0,0,0
2020-03-28,港澳客轮码头,入境,0,0,0,0
2020-03-28,港澳客轮码头,出境,0,0,0,0
2020-03-28,屯门客运码头,入境,0,0,0,0
2020-03-28,屯门客运码头,出境,0,0,0,0
2020-03-29,机场,入境,2616,6,215,2837
2020-03-29,机场,出境,301,25,77,403
2020-03-29,高铁西九龙,入境,0,0,0,0
2020-03-29,高铁西九龙,出境,0,0,0,0
2020-03-29,红磡,入境,0,0,0,0
2020-03-29,红磡,出境,0,0,0,0
2020-03-29,罗湖,入境,0,0,0,0
2020-03-29,罗湖,出境,0,0,0,0
2020-03-29,落马洲支线,入境,0,0,0,0
2020-03-29,落马洲支线,出境,0,0,0,0
2020-03-29,港珠澳大桥,入境,60,7,16,83
2020-03-29,港珠澳大桥,出境,36,5,181,222
2020-03-29,落马洲,入境,0,0,0,0
2020-03-29,落马洲,出境,0,0,0,0
2020-03-29,文锦渡,入境,0,0,0,0
2020-03-29,文锦渡,出境,0,0,0,0
2020-03-29,沙头角,入境,0,0,0,0
2020-03-29,沙头角,出境,0,0,0,0
2020-03-29,深圳湾,入境,554,110,0,664
2020-03-29,深圳湾,出境,221,67,2,290
2020-03-29,中国客运码头,入境,0,0,0,0
2020-03-29,中国客运码头,出境,0,0,0,0
2020-03-29,港口管制,入境,0,0,0,0
2020-03-29,港口管制,出境,0,0,0,0
2020-03-29,启德邮轮码头,入境,0,0,0,0
2020-03-29,启德邮轮码头,出境,0,0,0,0
2020-03-29,港澳客轮码头,入境,0,0,0,0
2020-03-29,港澳客轮码头,出境,0,0,0,0
2020-03-29,屯门客运码头,入境,0,0,0,0
2020-03-29,屯门客运码头,出境,0,0,0,0
2020-03-30,机场,入境,1924,7,138,2069
2020-03-30,机场,出境,346,10,92,448
2020-03-30,高铁西九龙,入境,0,0,0,0
2020-03-30,高铁西九龙,出境,0,0,0,0
2020-03-30,红磡,入境,0,0,0,0
2020-03-30,红磡,出境,0,0,0,0
2020-03-30,罗湖,入境,0,0,0,0
2020-03-30,罗湖,出境,0,0,0,0
2020-03-30,落马洲支线,入境,0,0,0,0
2020-03-30,落马洲支线,出境,0,0,0,0
2020-03-30,港珠澳大桥,入境,60,4,16,80
2020-03-30,港珠澳大桥,出境,50,4,145,199
2020-03-30,落马洲,入境,0,0,0,0
2020-03-30,落马洲,出境,0,0,0,0
2020-03-30,文锦渡,入境,0,0,0,0
2020-03-30,文锦渡,出境,0,0,0,0
2020-03-30,沙头角,入境,0,0,0,0
2020-03-30,沙头角,出境,0,0,0,0
2020-03-30,深圳湾,入境,704,79,1,784
2020-03-30,深圳湾,出境,284,82,4,370
2020-03-30,中国客运码头,入境,0,0,0,0
2020-03-30,中国客运码头,出境,0,0,0,0
2020-03-30,港口管制,入境,0,0,0,0
2020-03-30,港口管制,出境,0,0,0,0
2020-03-30,启德邮轮码头,入境,0,0,0,0
2020-03-30,启德邮轮码头,出境,0,0,0,0
2020-03-30,港澳客轮码头,入境,0,0,0,0
2020-03-30,港澳客轮码头,出境,0,0,0,0
2020-03-30,屯门客运码头,入境,0,0,0,0
2020-03-30,屯门客运码头,出境,0,0,0,0
2020-03-31,机场,入境,1406,9,119,1534
2020-03-31,机场,出境,569,20,142,731
2020-03-31,高铁西九龙,入境,0,0,0,0
2020-03-31,高铁西九龙,出境,0,0,0,0
2020-03-31,红磡,入境,0,0,0,0
2020-03-31,红磡,出境,0,0,0,0
2020-03-31,罗湖,入境,0,0,0,0
2020-03-31,罗湖,出境,0,0,0,0
2020-03-31,落马洲支线,入境,0,0,0,0
2020-03-31,落马洲支线,出境,0,0,0,0
2020-03-31,港珠澳大桥,入境,76,5,17,98
2020-03-31,港珠澳大桥,出境,56,6,122,184
2020-03-31,落马洲,入境,0,0,0,0
2020-03-31,落马洲,出境,0,0,0,0
2020-03-31,文锦渡,入境,0,0,0,0
2020-03-31,文锦渡,出境,0,0,0,0
2020-03-31,沙头角,入境,0,0,0,0
2020-03-31,沙头角,出境,0,0,0,0
2020-03-31,深圳湾,入境,763,97,3,863
2020-03-31,深圳湾,出境,366,67,3,436
2020-03-31,中国客运码头,入境,0,0,0,0
2020-03-31,中国客运码头,出境,0,0,0,0
2020-03-31,港口管制,入境,0,0,0,0
2020-03-31,港口管制,出境,0,0,0,0
2020-03-31,启德邮轮码头,入境,0,0,0,0
2020-03-31,启德邮轮码头,出境,0,0,0,0
2020-03-31,港澳客轮码头,入境,0,0,0,0
2020-03-31,港澳客轮码头,出境,0,0,0,0
2020-03-31,屯门客运码头,入境,0,0,0,0
2020-03-31,屯门客运码头,出境,0,0,0,0
2020-04-01,机场,入境,1144,5,34,1183
2020-04-01,机场,出境,526,36,86,648
2020-04-01,高铁西九龙,入境,0,0,0,0
2020-04-01,高铁西九龙,出境,0,0,0,0
2020-04-01,红磡,入境,0,0,0,0
2020-04-01,红磡,出境,0,0,0,0
2020-04-01,罗湖,入境,0,0,0,0
2020-04-01,罗湖,出境,0,0,0,0
2020-04-01,落马洲支线,入境,0,0,0,0
2020-04-01,落马洲支线,出境,0,0,0,0
2020-04-01,港珠澳大桥,入境,68,7,4,79
2020-04-01,港珠澳大桥,出境,42,4,16,62
2020-04-01,落马洲,入境,0,0,0,0
2020-04-01,落马洲,出境,0,0,0,0
2020-04-01,文锦渡,入境,0,0,0,0
2020-04-01,文锦渡,出境,0,0,0,0
2020-04-01,沙头角,入境,0,0,0,0
2020-04-01,沙头角,出境,0,0,0,0
2020-04-01,深圳湾,入境,798,84,2,884
2020-04-01,深圳湾,出境,385,123,0,508
2020-04-01,中国客运码头,入境,0,0,0,0
2020-04-01,中国客运码头,出境,0,0,0,0
2020-04-01,港口管制,入境,0,0,0,0
2020-04-01,港口管制,出境,0,0,0,0
2020-04-01,启德邮轮码头,入境,0,0,0,0
2020-04-01,启德邮轮码头,出境,0,0,0,0
2020-04-01,港澳客轮码头,入境,0,0,0,0
2020-04-01,港澳客轮码头,出境,0,0,0,0
2020-04-01,屯门客运码头,入境,0,0,0,0
2020-04-01,屯门客运码头,出境,0,0,0,0
2020-04-02,机场,入境,662,4,9,675
2020-04-02,机场,出境,269,21,59,349
2020-04-02,高铁西九龙,入境,0,0,0,0
2020-04-02,高铁西九龙,出境,0,0,0,0
2020-04-02,红磡,入境,0,0,0,0
2020-04-02,红磡,出境,0,0,0,0
2020-04-02,罗湖,入境,0,0,0,0
2020-04-02,罗湖,出境,0,0,0,0
2020-04-02,落马洲支线,入境,0,0,0,0
2020-04-02,落马洲支线,出境,0,0,0,0
2020-04-02,港珠澳大桥,入境,67,3,0,70
2020-04-02,港珠澳大桥,出境,70,0,6,76
2020-04-02,落马洲,入境,0,0,0,0
2020-04-02,落马洲,出境,0,0,0,0
2020-04-02,文锦渡,入境,0,0,0,0
2020-04-02,文锦渡,出境,0,0,0,0
2020-04-02,沙头角,入境,0,0,0,0
2020-04-02,沙头角,出境,0,0,0,0
2020-04-02,深圳湾,入境,631,69,0,700
2020-04-02,深圳湾,出境,371,87,7,465
2020-04-02,中国客运码头,入境,0,0,0,0
2020-04-02,中国客运码头,出境,0,0,0,0
2020-04-02,港口管制,入境,0,0,0,0
2020-04-02,港口管制,出境,0,0,0,0
2020-04-02,启德邮轮码头,入境,0,0,0,0
2020-04-02,启德邮轮码头,出境,0,0,0,0
2020-04-02,港澳客轮码头,入境,0,0,0,0
2020-04-02,港澳客轮码头,出境,0,0,0,0
2020-04-02,屯门客运码头,入境,0,0,0,0
2020-04-02,屯门客运码头,出境,0,0,0,0
2020-04-03,机场,入境,979,6,24,1009
2020-04-03,机场,出境,610,38,87,735
2020-04-03,高铁西九龙,入境,0,0,0,0
2020-04-03,高铁西九龙,出境,0,0,0,0
2020-04-03,红磡,入境,0,0,0,0
2020-04-03,红磡,出境,0,0,0,0
2020-04-03,罗湖,入境,0,0,0,0
2020-04-03,罗湖,出境,0,0,0,0
2020-04-03,落马洲支线,入境,0,0,0,0
2020-04-03,落马洲支线,出境,0,0,0,0
2020-04-03,港珠澳大桥,入境,59,6,4,69
2020-04-03,港珠澳大桥,出境,59,7,6,72
2020-04-03,落马洲,入境,0,0,0,0
2020-04-03,落马洲,出境,0,0,0,0
2020-04-03,文锦渡,入境,0,0,0,0
2020-04-03,文锦渡,出境,0,0,0,0
2020-04-03,沙头角,入境,0,0,0,0
2020-04-03,沙头角,出境,0,0,0,0
2020-04-03,深圳湾,入境,489,85,0,574
2020-04-03,深圳湾,出境,353,96,7,456
2020-04-03,中国客运码头,入境,0,0,0,0
2020-04-03,中国客运码头,出境,0,0,0,0
2020-04-03,港口管制,入境,0,0,0,0
2020-04-03,港口管制,出境,0,0,0,0
2020-04-03,启德邮轮码头,入境,0,0,0,0
2020-04-03,启德邮轮码头,出境,0,0,0,0
2020-04-03,港澳客轮码头,入境,0,0,0,0
2020-04-03,港澳客轮码头,出境,0,0,0,0
2020-04-03,屯门客运码头,入境,0,0,0,0
2020-04-03,屯门客运码头,出境,0,0,0,0
2020-04-04,机场,入境,812,3,15,830
2020-04-04,机场,出境,403,20,51,474
2020-04-04,高铁西九龙,入境,0,0,0,0
2020-04-04,高铁西九龙,出境,0,0,0,0
2020-04-04,红磡,入境,0,0,0,0
2020-04-04,红磡,出境,0,0,0,0
2020-04-04,罗湖,入境,0,0,0,0
2020-04-04,罗湖,出境,0,0,0,0
2020-04-04,落马洲支线,入境,0,0,0,0
2020-04-04,落马洲支线,出境,0,0,0,0
2020-04-04,港珠澳大桥,入境,50,2,3,55
2020-04-04,港珠澳大桥,出境,58,6,3,67
2020-04-04,落马洲,入境,0,0,0,0
2020-04-04,落马洲,出境,0,0,0,0
2020-04-04,文锦渡,入境,0,0,0,0
2020-04-04,文锦渡,出境,0,0,0,0
2020-04-04,沙头角,入境,0,0,0,0
2020-04-04,沙头角,出境,0,0,0,0
2020-04-04,深圳湾,入境,344,73,0,417
2020-04-04,深圳湾,出境,296,86,5,387
2020-04-04,中国客运码头,入境,0,0,0,0
2020-04-04,中国客运码头,出境,0,0,0,0
2020-04-04,港口管制,入境,0,0,0,0
2020-04-04,港口管制,出境,0,0,0,0
2020-04-04,启德邮轮码头,入境,0,0,0,0
2020-04-04,启德邮轮码头,出境,0,0,0,0
2020-04-04,港澳客轮码头,入境,0,0,0,0
2020-04-04,港澳客轮码头,出境,0,0,0,0
2020-04-04,屯门客运码头,入境,0,0,0,0
2020-04-04,屯门客运码头,出境,0,0,0,0
2020-04-05,机场,入境,806,0,7,813
2020-04-05,机场,出境,284,10,71,365
2020-04-05,高铁西九龙,入境,0,0,0,0
2020-04-05,高铁西九龙,出境,0,0,0,0
2020-04-05,红磡,入境,0,0,0,0
2020-04-05,红磡,出境,0,0,0,0
2020-04-05,罗湖,入境,0,0,0,0
2020-04-05,罗湖,出境,0,0,0,0
2020-04-05,落马洲支线,入境,0,0,0,0
2020-04-05,落马洲支线,出境,0,0,0,0
2020-04-05,港珠澳大桥,入境,226,12,18,256
2020-04-05,港珠澳大桥,出境,142,5,18,165
2020-04-05,落马洲,入境,0,0,0,0
2020-04-05,落马洲,出境,0,0,0,0
2020-04-05,文锦渡,入境,0,0,0,0
2020-04-05,文锦渡,出境,0,0,0,0
2020-04-05,沙头角,入境,0,0,0,0
2020-04-05,沙头角,出境,0,0,0,0
2020-04-05,深圳湾,入境,479,100,1,580
2020-04-05,深圳湾,出境,267,80,1,348
2020-04-05,中国客运码头,入境,0,0,0,0
2020-04-05,中国客运码头,出境,0,0,0,0
2020-04-05,港口管制,入境,0,0,0,0
2020-04-05,港口管制,出境,0,0,0,0
2020-04-05,启德邮轮码头,入境,0,0,0,0
2020-04-05,启德邮轮码头,出境,0,0,0,0
2020-04-05,港澳客轮码头,入境,0,0,0,0
2020-04-05,港澳客轮码头,出境,0,0,0,0
2020-04-05,屯门客运码头,入境,0,0,0,0
2020-04-05,屯门客运码头,出境,0,0,0,0
2020-04-06,机场,入境,833,2,13,848
2020-04-06,机场,出境,185,13,43,241
2020-04-06,高铁西九龙,入境,0,0,0,0
2020-04-06,高铁西九龙,出境,0,0,0,0
2020-04-06,红磡,入境,0,0,0,0
2020-04-06,红磡,出境,0,0,0,0
2020-04-06,罗湖,入境,0,0,0,0
2020-04-06,罗湖,出境,0,0,0,0
2020-04-06,落马洲支线,入境,0,0,0,0
2020-04-06,落马洲支线,出境,0,0,0,0
2020-04-06,港珠澳大桥,入境,20,7,1,28
2020-04-06,港珠澳大桥,出境,27,2,0,29
2020-04-06,落马洲,入境,0,0,0,0
2020-04-06,落马洲,出境,0,0,0,0
2020-04-06,文锦渡,入境,0,0,0,0
2020-04-06,文锦渡,出境,0,0,0,0
2020-04-06,沙头角,入境,0,0,0,0
2020-04-06,沙头角,出境,0,0,0,0
2020-04-06,深圳湾,入境,498,89,2,589
2020-04-06,深圳湾,出境,446,72,6,524
2020-04-06,中国客运码头,入境,0,0,0,0
2020-04-06,中国客运码头,出境,0,0,0,0
2020-04-06,港口管制,入境,0,0,0,0
2020-04-06,港口管制,出境,0,0,0,0
2020-04-06,启德邮轮码头,入境,0,0,0,0
2020-04-06,启德邮轮码头,出境,0,0,0,0
2020-04-06,港澳客轮码头,入境,0,0,0,0
2020-04-06,港澳客轮码头,出境,0,0,0,0
2020-04-06,屯门客运码头,入境,0,0,0,0
2020-04-06,屯门客运码头,出境,0,0,0,0
2020-04-07,机场,入境,347,4,16,367
2020-04-07,机场,出境,217,14,43,274
2020-04-07,高铁西九龙,入境,0,0,0,0
2020-04-07,高铁西九龙,出境,0,0,0,0
2020-04-07,红磡,入境,0,0,0,0
2020-04-07,红磡,出境,0,0,0,0
2020-04-07,罗湖,入境,0,0,0,0
2020-04-07,罗湖,出境,0,0,0,0
2020-04-07,落马洲支线,入境,0,0,0,0
2020-04-07,落马洲支线,出境,0,0,0,0
2020-04-07,港珠澳大桥,入境,34,8,0,42
2020-04-07,港珠澳大桥,出境,30,5,0,35
2020-04-07,落马洲,入境,0,0,0,0
2020-04-07,落马洲,出境,0,0,0,0
2020-04-07,文锦渡,入境,0,0,0,0
2020-04-07,文锦渡,出境,0,0,0,0
2020-04-07,沙头角,入境,0,0,0,0
2020-04-07,沙头角,出境,0,0,0,0
2020-04-07,深圳湾,入境,511,72,0,583
2020-04-07,深圳湾,出境,355,107,7,469
2020-04-07,中国客运码头,入境,0,0,0,0
2020-04-07,中国客运码头,出境,0,0,0,0
2020-04-07,港口管制,入境,0,0,0,0
2020-04-07,港口管制,出境,0,0,0,0
2020-04-07,启德邮轮码头,入境,0,0,0,0
2020-04-07,启德邮轮码头,出境,0,0,0,0
2020-04-07,港澳客轮码头,入境,0,0,0,0
2020-04-07,港澳客轮码头,出境,0,0,0,0
2020-04-07,屯门客运码头,入境,0,0,0,0
2020-04-07,屯门客运码头,出境,0,0,0,0
2020-04-08,机场,入境,835,6,24,865
2020-04-08,机场,出境,361,14,59,434
2020-04-08,高铁西九龙,入境,0,0,0,0
2020-04-08,高铁西九龙,出境,0,0,0,0
2020-04-08,红磡,入境,0,0,0,0
2020-04-08,红磡,出境,0,0,0,0
2020-04-08,罗湖,入境,0,0,0,0
2020-04-08,罗湖,出境,0,0,0,0
2020-04-08,落马洲支线,入境,0,0,0,0
2020-04-08,落马洲支线,出境,0,0,0,0
2020-04-08,港珠澳大桥,入境,24,3,0,27
2020-04-08,港珠澳大桥,出境,24,2,1,27
2020-04-08,落马洲,入境,0,0,0,0
2020-04-08,落马洲,出境,0,0,0,0
2020-04-08,文锦渡,入境,0,0,0,0
2020-04-08,文锦渡,出境,0,0,0,0
2020-04-08,沙头角,入境,0,0,0,0
2020-04-08,沙头角,出境,0,0,0,0
2020-04-08,深圳湾,入境,587,96,1,684
2020-04-08,深圳湾,出境,314,77,3,394
2020-04-08,中国客运码头,入境,0,0,0,0
2020-04-08,中国客运码头,出境,0,0,0,0
2020-04-08,港口管制,入境,0,0,0,0
2020-04-08,港口管制,出境,0,0,0,0
2020-04-08,启德邮轮码头,入境,0,0,0,0
2020-04-08,启德邮轮码头,出境,0,0,0,0
2020-04-08,港澳客轮码头,入境,0,0,0,0
2020-04-08,港澳客轮码头,出境,0,0,0,0
2020-04-08,屯门客运码头,入境,0,0,0,0
2020-04-08,屯门客运码头,出境,0,0,0,0
2020-04-09,机场,入境,439,0,17,456
2020-04-09,机场,出境,189,3,39,231
2020-04-09,高铁西九龙,入境,0,0,0,0
2020-04-09,高铁西九龙,出境,0,0,0,0
2020-04-09,红磡,入境,0,0,0,0
2020-04-09,红磡,出境,0,0,0,0
2020-04-09,罗湖,入境,0,0,0,0
2020-04-09,罗湖,出境,0,0,0,0
2020-04-09,落马洲支线,入境,0,0,0,0
2020-04-09,落马洲支线,出境,0,0,0,0
2020-04-09,港珠澳大桥,入境,33,8,0,41
2020-04-09,港珠澳大桥,出境,16,7,2,25
2020-04-09,落马洲,入境,0,0,0,0
2020-04-09,落马洲,出境,0,0,0,0
2020-04-09,文锦渡,入境,0,0,0,0
2020-04-09,文锦渡,出境,0,0,0,0
2020-04-09,沙头角,入境,0,0,0,0
2020-04-09,沙头角,出境,0,0,0,0
2020-04-09,深圳湾,入境,584,85,1,670
2020-04-09,深圳湾,出境,349,122,3,474
2020-04-09,中国客运码头,入境,0,0,0,0
2020-04-09,中国客运码头,出境,0,0,0,0
2020-04-09,港口管制,入境,0,0,0,0
2020-04-09,港口管制,出境,0,0,0,0
2020-04-09,启德邮轮码头,入境,0,0,0,0
2020-04-09,启德邮轮码头,出境,0,0,0,0
2020-04-09,港澳客轮码头,入境,0,0,0,0
2020-04-09,港澳客轮码头,出境,0,0,0,0
2020-04-09,屯门客运码头,入境,0,0,0,0
2020-04-09,屯门客运码头,出境,0,0,0,0
2020-04-10,机场,入境,811,9,39,859
2020-04-10,机场,出境,503,20,74,597
2020-04-10,高铁西九龙,入境,0,0,0,0
2020-04-10,高铁西九龙,出境,0,0,0,0
2020-04-10,红磡,入境,0,0,0,0
2020-04-10,红磡,出境,0,0,0,0
2020-04-10,罗湖,入境,0,0,0,0
2020-04-10,罗湖,出境,0,0,0,0
2020-04-10,落马洲支线,入境,0,0,0,0
2020-04-10,落马洲支线,出境,0,0,0,0
2020-04-10,港珠澳大桥,入境,36,6,0,42
2020-04-10,港珠澳大桥,出境,16,3,3,22
2020-04-10,落马洲,入境,0,0,0,0
2020-04-10,落马洲,出境,0,0,0,0
2020-04-10,文锦渡,入境,0,0,0,0
2020-04-10,文锦渡,出境,0,0,0,0
2020-04-10,沙头角,入境,0,0,0,0
2020-04-10,沙头角,出境,0,0,0,0
2020-04-10,深圳湾,入境,613,131,1,745
2020-04-10,深圳湾,出境,397,129,1,527
2020-04-10,中国客运码头,入境,0,0,0,0
2020-04-10,中国客运码头,出境,0,0,0,0
2020-04-10,港口管制,入境,0,0,0,0
2020-04-10,港口管制,出境,0,0,0,0
2020-04-10,启德邮轮码头,入境,0,0,0,0
2020-04-10,启德邮轮码头,出境,0,0,0,0
2020-04-10,港澳客轮码头,入境,0,0,0,0
2020-04-10,港澳客轮码头,出境,0,0,0,0
2020-04-10,屯门客运码头,入境,0,0,0,0
2020-04-10,屯门客运码头,出境,0,0,0,0
2020-04-11,机场,入境,220,0,8,228
2020-04-11,机场,出境,195,4,33,232
2020-04-11,高铁西九龙,入境,0,0,0,0
2020-04-11,高铁西九龙,出境,0,0,0,0
2020-04-11,红磡,入境,0,0,0,0
2020-04-11,红磡,出境,0,0,0,0
2020-04-11,罗湖,入境,0,0,0,0
2020-04-11,罗湖,出境,0,0,0,0
2020-04-11,落马洲支线,入境,0,0,0,0
2020-04-11,落马洲支线,出境,0,0,0,0
2020-04-11,港珠澳大桥,入境,22,9,4,35
2020-04-11,港珠澳大桥,出境,23,2,2,27
2020-04-11,落马洲,入境,0,0,0,0
2020-04-11,落马洲,出境,0,0,0,0
2020-04-11,文锦渡,入境,0,0,0,0
2020-04-11,文锦渡,出境,0,0,0,0
2020-04-11,沙头角,入境,0,0,0,0
2020-04-11,沙头角,出境,0,0,0,0
2020-04-11,深圳湾,入境,590,102,5,697
2020-04-11,深圳湾,出境,306,58,2,366
2020-04-11,中国客运码头,入境,0,0,0,0
2020-04-11,中国客运码头,出境,0,0,0,0
2020-04-11,港口管制,入境,0,0,0,0
2020-04-11,港口管制,出境,0,0,0,0
2020-04-11,启德邮轮码头,入境,0,0,0,0
2020-04-11,启德邮轮码头,出境,0,0,0,0
2020-04-11,港澳客轮码头,入境,0,0,0,0
2020-04-11,港澳客轮码头,出境,0,0,0,0
2020-04-11,屯门客运码头,入境,0,0,0,0
2020-04-11,屯门客运码头,出境,0,0,0,0
2020-04-12,机场,入境,544,4,24,572
2020-04-12,机场,出境,352,30,54,436
2020-04-12,高铁西九龙,入境,0,0,0,0
2020-04-12,高铁西九龙,出境,0,0,0,0
2020-04-12,红磡,入境,0,0,0,0
2020-04-12,红磡,出境,0,0,0,0
2020-04-12,罗湖,入境,0,0,0,0
2020-04-12,罗湖,出境,0,0,0,0
2020-04-12,落马洲支线,入境,0,0,0,0
2020-04-12,落马洲支线,出境,0,0,0,0
2020-04-12,港珠澳大桥,入境,49,4,1,54
2020-04-12,港珠澳大桥,出境,10,0,0,10
2020-04-12,落马洲,入境,0,0,0,0
2020-04-12,落马洲,出境,0,0,0,0
2020-04-12,文锦渡,入境,0,0,0,0
2020-04-12,文锦渡,出境,0,0,0,0
2020-04-12,沙头角,入境,0,0,0,0
2020-04-12,沙头角,出境,0,0,0,0
2020-04-12,深圳湾,入境,455,99,1,555
2020-04-12,深圳湾,出境,258,57,1,316
2020-04-12,中国客运码头,入境,0,0,0,0
2020-04-12,中国客运码头,出境,0,0,0,0
2020-04-12,港口管制,入境,0,0,0,0
2020-04-12,港口管制,出境,0,0,0,0
2020-04-12,启德邮轮码头,入境,0,0,0,0
2020-04-12,启德邮轮码头,出境,0,0,0,0
2020-04-12,港澳客轮码头,入境,0,0,0,0
2020-04-12,港澳客轮码头,出境,0,0,0,0
2020-04-12,屯门客运码头,入境,0,0,0,0
2020-04-12,屯门客运码头,出境,0,0,0,0
2020-04-13,机场,入境,395,1,18,414
2020-04-13,机场,出境,71,6,28,105
2020-04-13,高铁西九龙,入境,0,0,0,0
2020-04-13,高铁西九龙,出境,0,0,0,0
2020-04-13,红磡,入境,0,0,0,0
2020-04-13,红磡,出境,0,0,0,0
2020-04-13,罗湖,入境,0,0,0,0
2020-04-13,罗湖,出境,0,0,0,0
2020-04-13,落马洲支线,入境,0,0,0,0
2020-04-13,落马洲支线,出境,0,0,0,0
2020-04-13,港珠澳大桥,入境,51,3,0,54
2020-04-13,港珠澳大桥,出境,17,1,1,19
2020-04-13,落马洲,入境,0,0,0,0
2020-04-13,落马洲,出境,0,0,0,0
2020-04-13,文锦渡,入境,0,0,0,0
2020-04-13,文锦渡,出境,0,0,0,0
2020-04-13,沙头角,入境,0,0,0,0
2020-04-13,沙头角,出境,0,0,0,0
2020-04-13,深圳湾,入境,511,98,5,614
2020-04-13,深圳湾,出境,273,72,4,349
2020-04-13,中国客运码头,入境,0,0,0,0
2020-04-13,中国客运码头,出境,0,0,0,0
2020-04-13,港口管制,入境,0,0,0,0
2020-04-13,港口管制,出境,0,0,0,0
2020-04-13,启德邮轮码头,入境,0,0,0,0
2020-04-13,启德邮轮码头,出境,0,0,0,0
2020-04-13,港澳客轮码头,入境,0,0,0,0
2020-04-13,港澳客轮码头,出境,0,0,0,0
2020-04-13,屯门客运码头,入境,0,0,0,0
2020-04-13,屯门客运码头,出境,0,0,0,0
2020-04-14,机场,入境,430,7,10,447
2020-04-14,机场,出境,150,10,50,210
2020-04-14,高铁西九龙,入境,0,0,0,0
2020-04-14,高铁西九龙,出境,0,0,0,0
2020-04-14,红磡,入境,0,0,0,0
2020-04-14,红磡,出境,0,0,0,0
2020-04-14,罗湖,入境,0,0,0,0
2020-04-14,罗湖,出境,0,0,0,0
2020-04-14,落马洲支线,入境,0,0,0,0
2020-04-14,落马洲支线,出境,0,0,0,0
2020-04-14,港珠澳大桥,入境,36,4,1,41
2020-04-14,港珠澳大桥,出境,21,5,3,29
2020-04-14,落马洲,入境,0,0,0,0
2020-04-14,落马洲,出境,0,0,0,0
2020-04-14,文锦渡,入境,0,0,0,0
2020-04-14,文锦渡,出境,0,0,0,0
2020-04-14,沙头角,入境,0,0,0,0
2020-04-14,沙头角,出境,0,0,0,0
2020-04-14,深圳湾,入境,588,70,0,658
2020-04-14,深圳湾,出境,275,64,1,340
2020-04-14,中国客运码头,入境,0,0,0,0
2020-04-14,中国客运码头,出境,0,0,0,0
2020-04-14,港口管制,入境,0,0,0,0
2020-04-14,港口管制,出境,0,0,0,0
2020-04-14,启德邮轮码头,入境,0,0,0,0
2020-04-14,启德邮轮码头,出境,0,0,0,0
2020-04-14,港澳客轮码头,入境,0,0,0,0
2020-04-14,港澳客轮码头,出境,0,0,0,0
2020-04-14,屯门客运码头,入境,0,0,0,0
2020-04-14,屯门客运码头,出境,0,0,0,0
2020-04-15,机场,入境,481,2,16,499
2020-04-15,机场,出境,331,12,60,403
2020-04-15,高铁西九龙,入境,0,0,0,0
2020-04-15,高铁西九龙,出境,0,0,0,0
2020-04-15,红磡,入境,0,0,0,0
2020-04-15,红磡,出境,0,0,0,0
2020-04-15,罗湖,入境,0,0,0,0
2020-04-15,罗湖,出境,0,0,0,0
2020-04-15,落马洲支线,入境,0,0,0,0
2020-04-15,落马洲支线,出境,0,0,0,0
2020-04-15,港珠澳大桥,入境,33,4,1,38
2020-04-15,港珠澳大桥,出境,17,3,0,20
2020-04-15,落马洲,入境,0,0,0,0
2020-04-15,落马洲,出境,0,0,0,0
2020-04-15,文锦渡,入境,0,0,0,0
2020-04-15,文锦渡,出境,0,0,0,0
2020-04-15,沙头角,入境,0,0,0,0
2020-04-15,沙头角,出境,0,0,0,0
2020-04-15,深圳湾,入境,613,93,1,707
2020-04-15,深圳湾,出境,240,69,2,311
2020-04-15,中国客运码头,入境,0,0,0,0
2020-04-15,中国客运码头,出境,0,0,0,0
2020-04-15,港口管制,入境,0,0,0,0
2020-04-15,港口管制,出境,0,0,0,0
2020-04-15,启德邮轮码头,入境,0,0,0,0
2020-04-15,启德邮轮码头,出境,0,0,0,0
2020-04-15,港澳客轮码头,入境,0,0,0,0
2020-04-15,港澳客轮码头,出境,0,0,0,0
2020-04-15,屯门客运码头,入境,0,0,0,0
2020-04-15,屯门客运码头,出境,0,0,0,0
2020-04-16,机场,入境,397,1,19,417
2020-04-16,机场,出境,147,15,24,186
2020-04-16,高铁西九龙,入境,0,0,0,0
2020-04-16,高铁西九龙,出境,0,0,0,0
2020-04-16,红磡,入境,0,0,0,0
2020-04-16,红磡,出境,0,0,0,0
2020-04-16,罗湖,入境,0,0,0,0
2020-04-16,罗湖,出境,0,0,0,0
2020-04-16,落马洲支线,入境,0,0,0,0
2020-04-16,落马洲支线,出境,0,0,0,0
2020-04-16,港珠澳大桥,入境,26,2,0,28
2020-04-16,港珠澳大桥,出境,11,0,1,12
2020-04-16,落马洲,入境,0,0,0,0
2020-04-16,落马洲,出境,0,0,0,0
2020-04-16,文锦渡,入境,0,0,0,0
2020-04-16,文锦渡,出境,0,0,0,0
2020-04-16,沙头角,入境,0,0,0,0
2020-04-16,沙头角,出境,0,0,0,0
2020-04-16,深圳湾,入境,527,81,3,611
2020-04-16,深圳湾,出境,223,56,0,279
2020-04-16,中国客运码头,入境,0,0,0,0
2020-04-16,中国客运码头,出境,0,0,0,0
2020-04-16,港口管制,入境,0,0,0,0
2020-04-16,港口管制,出境,0,0,0,0
2020-04-16,启德邮轮码头,入境,0,0,0,0
2020-04-16,启德邮轮码头,出境,0,0,0,0
2020-04-16,港澳客轮码头,入境,0,0,0,0
2020-04-16,港澳客轮码头,出境,0,0,0,0
2020-04-16,屯门客运码头,入境,0,0,0,0
2020-04-16,屯门客运码头,出境,0,0,0,0
2020-04-17,机场,入境,820,6,20,846
2020-04-17,机场,出境,507,15,80,602
2020-04-17,高铁西九龙,入境,0,0,0,0
2020-04-17,高铁西九龙,出境,0,0,0,0
2020-04-17,红磡,入境,0,0,0,0
2020-04-17,红磡,出境,0,0,0,0
2020-04-17,罗湖,入境,0,0,0,0
2020-04-17,罗湖,出境,0,0,0,0
2020-04-17,落马洲支线,入境,0,0,0,0
2020-04-17,落马洲支线,出境,0,0,0,0
2020-04-17,港珠澳大桥,入境,24,4,2,30
2020-04-17,港珠澳大桥,出境,27,2,2,31
2020-04-17,落马洲,入境,0,0,0,0
2020-04-17,落马洲,出境,0,0,0,0
2020-04-17,文锦渡,入境,0,0,0,0
2020-04-17,文锦渡,出境,0,0,0,0
2020-04-17,沙头角,入境,0,0,0,0
2020-04-17,沙头角,出境,0,0,0,0
2020-04-17,深圳湾,入境,519,77,4,600
2020-04-17,深圳湾,出境,180,54,4,238
2020-04-17,中国客运码头,入境,0,0,0,0
2020-04-17,中国客运码头,出境,0,0,0,0
2020-04-17,港口管制,入境,0,0,0,0
2020-04-17,港口管制,出境,0,0,0,0
2020-04-17,启德邮轮码头,入境,0,0,0,0
2020-04-17,启德邮轮码头,出境,0,0,0,0
2020-04-17,港澳客轮码头,入境,0,0,0,0
2020-04-17,港澳客轮码头,出境,0,0,0,0
2020-04-17,屯门客运码头,入境,0,0,0,0
2020-04-17,屯门客运码头,出境,0,0,0,0
2020-04-18,机场,入境,373,9,14,396
2020-04-18,机场,出境,336,19,67,422
2020-04-18,高铁西九龙,入境,0,0,0,0
2020-04-18,高铁西九龙,出境,0,0,0,0
2020-04-18,红磡,入境,0,0,0,0
2020-04-18,红磡,出境,0,0,0,0
2020-04-18,罗湖,入境,0,0,0,0
2020-04-18,罗湖,出境,0,0,0,0
2020-04-18,落马洲支线,入境,0,0,0,0
2020-04-18,落马洲支线,出境,0,0,0,0
2020-04-18,港珠澳大桥,入境,33,8,1,42
2020-04-18,港珠澳大桥,出境,11,4,6,21
2020-04-18,落马洲,入境,0,0,0,0
2020-04-18,落马洲,出境,0,0,0,0
2020-04-18,文锦渡,入境,0,0,0,0
2020-04-18,文锦渡,出境,0,0,0,0
2020-04-18,沙头角,入境,0,0,0,0
2020-04-18,沙头角,出境,0,0,0,0
2020-04-18,深圳湾,入境,456,86,0,542
2020-04-18,深圳湾,出境,194,65,4,263
2020-04-18,中国客运码头,入境,0,0,0,0
2020-04-18,中国客运码头,出境,0,0,0,0
2020-04-18,港口管制,入境,0,0,0,0
2020-04-18,港口管制,出境,0,0,0,0
2020-04-18,启德邮轮码头,入境,0,0,0,0
2020-04-18,启德邮轮码头,出境,0,0,0,0
2020-04-18,港澳客轮码头,入境,0,0,0,0
2020-04-18,港澳客轮码头,出境,0,0,0,0
2020-04-18,屯门客运码头,入境,0,0,0,0
2020-04-18,屯门客运码头,出境,0,0,0,0
2020-04-19,机场,入境,452,2,13,467
2020-04-19,机场,出境,273,2,44,319
2020-04-19,高铁西九龙,入境,0,0,0,0
2020-04-19,高铁西九龙,出境,0,0,0,0
2020-04-19,红磡,入境,0,0,0,0
2020-04-19,红磡,出境,0,0,0,0
2020-04-19,罗湖,入境,0,0,0,0
2020-04-19,罗湖,出境,0,0,0,0
2020-04-19,落马洲支线,入境,0,0,0,0
2020-04-19,落马洲支线,出境,0,0,0,0
2020-04-19,港珠澳大桥,入境,21,1,0,22
2020-04-19,港珠澳大桥,出境,7,0,0,7
2020-04-19,落马洲,入境,0,0,0,0
2020-04-19,落马洲,出境,0,0,0,0
2020-04-19,文锦渡,入境,0,0,0,0
2020-04-19,文锦渡,出境,0,0,0,0
2020-04-19,沙头角,入境,0,0,0,0
2020-04-19,沙头角,出境,0,0,0,0
2020-04-19,深圳湾,入境,543,96,3,642
2020-04-19,深圳湾,出境,168,53,0,221
2020-04-19,中国客运码头,入境,0,0,0,0
2020-04-19,中国客运码头,出境,0,0,0,0
2020-04-19,港口管制,入境,0,0,0,0
2020-04-19,港口管制,出境,0,0,0,0
2020-04-19,启德邮轮码头,入境,0,0,0,0
2020-04-19,启德邮轮码头,出境,0,0,0,0
2020-04-19,港澳客轮码头,入境,0,0,0,0
2020-04-19,港澳客轮码头,出境,0,0,0,0
2020-04-19,屯门客运码头,入境,0,0,0,0
2020-04-19,屯门客运码头,出境,0,0,0,0
2020-04-20,机场,入境,460,6,20,486
2020-04-20,机场,出境,190,26,25,241
2020-04-20,高铁西九龙,入境,0,0,0,0
2020-04-20,高铁西九龙,出境,0,0,0,0
2020-04-20,红磡,入境,0,0,0,0
2020-04-20,红磡,出境,0,0,0,0
2020-04-20,罗湖,入境,0,0,0,0
2020-04-20,罗湖,出境,0,0,0,0
2020-04-20,落马洲支线,入境,0,0,0,0
2020-04-20,落马洲支线,出境,0,0,0,0
2020-04-20,港珠澳大桥,入境,40,0,1,41
2020-04-20,港珠澳大桥,出境,12,1,0,13
2020-04-20,落马洲,入境,0,0,0,0
2020-04-20,落马洲,出境,0,0,0,0
2020-04-20,文锦渡,入境,0,0,0,0
2020-04-20,文锦渡,出境,0,0,0,0
2020-04-20,沙头角,入境,0,0,0,0
2020-04-20,沙头角,出境,0,0,0,0
2020-04-20,深圳湾,入境,663,80,2,745
2020-04-20,深圳湾,出境,306,73,7,386
2020-04-20,中国客运码头,入境,0,0,0,0
2020-04-20,中国客运码头,出境,0,0,0,0
2020-04-20,港口管制,入境,0,0,0,0
2020-04-20,港口管制,出境,0,0,0,0
2020-04-20,启德邮轮码头,入境,0,0,0,0
2020-04-20,启德邮轮码头,出境,0,0,0,0
2020-04-20,港澳客轮码头,入境,0,0,0,0
2020-04-20,港澳客轮码头,出境,0,0,0,0
2020-04-20,屯门客运码头,入境,0,0,0,0
2020-04-20,屯门客运码头,出境,0,0,0,0
2020-04-21,机场,入境,324,3,22,349
2020-04-21,机场,出境,86,3,28,117
2020-04-21,高铁西九龙,入境,0,0,0,0
2020-04-21,高铁西九龙,出境,0,0,0,0
2020-04-21,红磡,入境,0,0,0,0
2020-04-21,红磡,出境,0,0,0,0
2020-04-21,罗湖,入境,0,0,0,0
2020-04-21,罗湖,出境,0,0,0,0
2020-04-21,落马洲支线,入境,0,0,0,0
2020-04-21,落马洲支线,出境,0,0,0,0
2020-04-21,港珠澳大桥,入境,24,4,0,28
2020-04-21,港珠澳大桥,出境,24,5,2,31
2020-04-21,落马洲,入境,0,0,0,0
2020-04-21,落马洲,出境,0,0,0,0
2020-04-21,文锦渡,入境,0,0,0,0
2020-04-21,文锦渡,出境,0,0,0,0
2020-04-21,沙头角,入境,0,0,0,0
2020-04-21,沙头角,出境,0,0,0,0
2020-04-21,深圳湾,入境,438,66,1,505
2020-04-21,深圳湾,出境,213,37,1,251
2020-04-21,中国客运码头,入境,0,0,0,0
2020-04-21,中国客运码头,出境,0,0,0,0
2020-04-21,港口管制,入境,0,0,0,0
2020-04-21,港口管制,出境,0,0,0,0
2020-04-21,启德邮轮码头,入境,0,0,0,0
2020-04-21,启德邮轮码头,出境,0,0,0,0
2020-04-21,港澳客轮码头,入境,0,0,0,0
2020-04-21,港澳客轮码头,出境,0,0,0,0
2020-04-21,屯门客运码头,入境,0,0,0,0
2020-04-21,屯门客运码头,出境,0,0,0,0
2020-04-22,机场,入境,561,2,29,592
2020-04-22,机场,出境,243,6,57,306
2020-04-22,高铁西九龙,入境,0,0,0,0
2020-04-22,高铁西九龙,出境,0,0,0,0
2020-04-22,红磡,入境,0,0,0,0
2020-04-22,红磡,出境,0,0,0,0
2020-04-22,罗湖,入境,0,0,0,0
2020-04-22,罗湖,出境,0,0,0,0
2020-04-22,落马洲支线,入境,0,0,0,0
2020-04-22,落马洲支线,出境,0,0,0,0
2020-04-22,港珠澳大桥,入境,47,3,1,51
2020-04-22,港珠澳大桥,出境,11,4,1,16
2020-04-22,落马洲,入境,0,0,0,0
2020-04-22,落马洲,出境,0,0,0,0
2020-04-22,文锦渡,入境,0,0,0,0
2020-04-22,文锦渡,出境,0,0,0,0
2020-04-22,沙头角,入境,0,0,0,0
2020-04-22,沙头角,出境,0,0,0,0
2020-04-22,深圳湾,入境,384,60,3,447
2020-04-22,深圳湾,出境,242,44,0,286
2020-04-22,中国客运码头,入境,0,0,0,0
2020-04-22,中国客运码头,出境,0,0,0,0
2020-04-22,港口管制,入境,0,0,0,0
2020-04-22,港口管制,出境,0,0,0,0
2020-04-22,启德邮轮码头,入境,0,0,0,0
2020-04-22,启德邮轮码头,出境,0,0,0,0
2020-04-22,港澳客轮码头,入境,0,0,0,0
2020-04-22,港澳客轮码头,出境,0,0,0,0
2020-04-22,屯门客运码头,入境,0,0,0,0
2020-04-22,屯门客运码头,出境,0,0,0,0
2020-04-23,机场,入境,241,2,19,262
2020-04-23,机场,出境,179,13,59,251
2020-04-23,高铁西九龙,入境,0,0,0,0
2020-04-23,高铁西九龙,出境,0,0,0,0
2020-04-23,红磡,入境,0,0,0,0
2020-04-23,红磡,出境,0,0,0,0
2020-04-23,罗湖,入境,0,0,0,0
2020-04-23,罗湖,出境,0,0,0,0
2020-04-23,落马洲支线,入境,0,0,0,0
2020-04-23,落马洲支线,出境,0,0,0,0
2020-04-23,港珠澳大桥,入境,24,1,1,26
2020-04-23,港珠澳大桥,出境,8,1,2,11
2020-04-23,落马洲,入境,0,0,0,0
2020-04-23,落马洲,出境,0,0,0,0
2020-04-23,文锦渡,入境,0,0,0,0
2020-04-23,文锦渡,出境,0,0,0,0
2020-04-23,沙头角,入境,0,0,0,0
2020-04-23,沙头角,出境,0,0,0,0
2020-04-23,深圳湾,入境,351,56,1,408
2020-04-23,深圳湾,出境,210,64,1,275
2020-04-23,中国客运码头,入境,0,0,0,0
2020-04-23,中国客运码头,出境,0,0,0,0
2020-04-23,港口管制,入境,0,0,0,0
2020-04-23,港口管制,出境,0,0,0,0
2020-04-23,启德邮轮码头,入境,0,0,0,0
2020-04-23,启德邮轮码头,出境,0,0,0,0
2020-04-23,港澳客轮码头,入境,0,0,0,0
2020-04-23,港澳客轮码头,出境,0,0,0,0
2020-04-23,屯门客运码头,入境,0,0,0,0
2020-04-23,屯门客运码头,出境,0,0,0,0
2020-04-24,机场,入境,817,0,26,843
2020-04-24,机场,出境,374,5,63,442
2020-04-24,高铁西九龙,入境,0,0,0,0
2020-04-24,高铁西九龙,出境,0,0,0,0
2020-04-24,红磡,入境,0,0,0,0
2020-04-24,红磡,出境,0,0,0,0
2020-04-24,罗湖,入境,0,0,0,0
2020-04-24,罗湖,出境,0,0,0,0
2020-04-24,落马洲支线,入境,0,0,0,0
2020-04-24,落马洲支线,出境,0,0,0,0
2020-04-24,港珠澳大桥,入境,36,2,0,38
2020-04-24,港珠澳大桥,出境,13,2,0,15
2020-04-24,落马洲,入境,0,0,0,0
2020-04-24,落马洲,出境,0,0,0,0
2020-04-24,文锦渡,入境,0,0,0,0
2020-04-24,文锦渡,出境,0,0,0,0
2020-04-24,沙头角,入境,0,0,0,0
2020-04-24,沙头角,出境,0,0,0,0
2020-04-24,深圳湾,入境,397,38,0,435
2020-04-24,深圳湾,出境,214,36,2,252
2020-04-24,中国客运码头,入境,0,0,0,0
2020-04-24,中国客运码头,出境,0,0,0,0
2020-04-24,港口管制,入境,0,0,0,0
2020-04-24,港口管制,出境,0,0,0,0
2020-04-24,启德邮轮码头,入境,0,0,0,0
2020-04-24,启德邮轮码头,出境,0,0,0,0
2020-04-24,港澳客轮码头,入境,0,0,0,0
2020-04-24,港澳客轮码头,出境,0,0,0,0
2020-04-24,屯门客运码头,入境,0,0,0,0
2020-04-24,屯门客运码头,出境,0,0,0,0
2020-04-25,机场,入境,378,7,20,405
2020-04-25,机场,出境,241,13,41,295
2020-04-25,高铁西九龙,入境,0,0,0,0
2020-04-25,高铁西九龙,出境,0,0,0,0
2020-04-25,红磡,入境,0,0,0,0
2020-04-25,红磡,出境,0,0,0,0
2020-04-25,罗湖,入境,0,0,0,0
2020-04-25,罗湖,出境,0,0,0,0
2020-04-25,落马洲支线,入境,0,0,0,0
2020-04-25,落马洲支线,出境,0,0,0,0
2020-04-25,港珠澳大桥,入境,26,1,0,27
2020-04-25,港珠澳大桥,出境,19,0,0,19
2020-04-25,落马洲,入境,0,0,0,0
2020-04-25,落马洲,出境,0,0,0,0
2020-04-25,文锦渡,入境,0,0,0,0
2020-04-25,文锦渡,出境,0,0,0,0
2020-04-25,沙头角,入境,0,0,0,0
2020-04-25,沙头角,出境,0,0,0,0
2020-04-25,深圳湾,入境,429,67,4,500
2020-04-25,深圳湾,出境,208,37,0,245
2020-04-25,中国客运码头,入境,0,0,0,0
2020-04-25,中国客运码头,出境,0,0,0,0
2020-04-25,港口管制,入境,0,0,0,0
2020-04-25,港口管制,出境,0,0,0,0
2020-04-25,启德邮轮码头,入境,0,0,0,0
2020-04-25,启德邮轮码头,出境,0,0,0,0
2020-04-25,港澳客轮码头,入境,0,0,0,0
2020-04-25,港澳客轮码头,出境,0,0,0,0
2020-04-25,屯门客运码头,入境,0,0,0,0
2020-04-25,屯门客运码头,出境,0,0,0,0
2020-04-26,机场,入境,421,1,20,442
2020-04-26,机场,出境,333,18,35,386
2020-04-26,高铁西九龙,入境,0,0,0,0
2020-04-26,高铁西九龙,出境,0,0,0,0
2020-04-26,红磡,入境,0,0,0,0
2020-04-26,红磡,出境,0,0,0,0
2020-04-26,罗湖,入境,0,0,0,0
2020-04-26,罗湖,出境,0,0,0,0
2020-04-26,落马洲支线,入境,0,0,0,0
2020-04-26,落马洲支线,出境,0,0,0,0
2020-04-26,港珠澳大桥,入境,21,1,0,22
2020-04-26,港珠澳大桥,出境,8,1,0,9
2020-04-26,落马洲,入境,0,0,0,0
2020-04-26,落马洲,出境,0,0,0,0
2020-04-26,文锦渡,入境,0,0,0,0
2020-04-26,文锦渡,出境,0,0,0,0
2020-04-26,沙头角,入境,0,0,0,0
2020-04-26,沙头角,出境,0,0,0,0
2020-04-26,深圳湾,入境,407,80,4,491
2020-04-26,深圳湾,出境,184,59,2,245
2020-04-26,中国客运码头,入境,0,0,0,0
2020-04-26,中国客运码头,出境,0,0,0,0
2020-04-26,港口管制,入境,0,0,0,0
2020-04-26,港口管制,出境,0,0,0,0
2020-04-26,启德邮轮码头,入境,0,0,0,0
2020-04-26,启德邮轮码头,出境,0,0,0,0
2020-04-26,港澳客轮码头,入境,0,0,0,0
2020-04-26,港澳客轮码头,出境,0,0,0,0
2020-04-26,屯门客运码头,入境,0,0,0,0
2020-04-26,屯门客运码头,出境,0,0,0,0
2020-04-27,机场,入境,411,2,10,423
2020-04-27,机场,出境,125,1,22,148
2020-04-27,高铁西九龙,入境,0,0,0,0
2020-04-27,高铁西九龙,出境,0,0,0,0
2020-04-27,红磡,入境,0,0,0,0
2020-04-27,红磡,出境,0,0,0,0
2020-04-27,罗湖,入境,0,0,0,0
2020-04-27,罗湖,出境,0,0,0,0
2020-04-27,落马洲支线,入境,0,0,0,0
2020-04-27,落马洲支线,出境,0,0,0,0
2020-04-27,港珠澳大桥,入境,33,2,1,36
2020-04-27,港珠澳大桥,出境,36,1,3,40
2020-04-27,落马洲,入境,0,0,0,0
2020-04-27,落马洲,出境,0,0,0,0
2020-04-27,文锦渡,入境,0,0,0,0
2020-04-27,文锦渡,出境,0,0,0,0
2020-04-27,沙头角,入境,0,0,0,0
2020-04-27,沙头角,出境,0,0,0,0
2020-04-27,深圳湾,入境,454,70,1,525
2020-04-27,深圳湾,出境,577,146,7,730
2020-04-27,中国客运码头,入境,0,0,0,0
2020-04-27,中国客运码头,出境,0,0,0,0
2020-04-27,港口管制,入境,0,0,0,0
2020-04-27,港口管制,出境,0,0,0,0
2020-04-27,启德邮轮码头,入境,0,0,0,0
2020-04-27,启德邮轮码头,出境,0,0,0,0
2020-04-27,港澳客轮码头,入境,0,0,0,0
2020-04-27,港澳客轮码头,出境,0,0,0,0
2020-04-27,屯门客运码头,入境,0,0,0,0
2020-04-27,屯门客运码头,出境,0,0,0,0
2020-04-28,机场,入境,464,0,64,528
2020-04-28,机场,出境,160,1,50,211
2020-04-28,高铁西九龙,入境,0,0,0,0
2020-04-28,高铁西九龙,出境,0,0,0,0
2020-04-28,红磡,入境,0,0,0,0
2020-04-28,红磡,出境,0,0,0,0
2020-04-28,罗湖,入境,0,0,0,0
2020-04-28,罗湖,出境,0,0,0,0
2020-04-28,落马洲支线,入境,0,0,0,0
2020-04-28,落马洲支线,出境,0,0,0,0
2020-04-28,港珠澳大桥,入境,22,2,1,25
2020-04-28,港珠澳大桥,出境,19,1,3,23
2020-04-28,落马洲,入境,0,0,0,0
2020-04-28,落马洲,出境,0,0,0,0
2020-04-28,文锦渡,入境,0,0,0,0
2020-04-28,文锦渡,出境,0,0,0,0
2020-04-28,沙头角,入境,0,0,0,0
2020-04-28,沙头角,出境,0,0,0,0
2020-04-28,深圳湾,入境,341,49,1,391
2020-04-28,深圳湾,出境,176,25,3,204
2020-04-28,中国客运码头,入境,0,0,0,0
2020-04-28,中国客运码头,出境,0,0,0,0
2020-04-28,港口管制,入境,0,0,0,0
2020-04-28,港口管制,出境,0,0,0,0
2020-04-28,启德邮轮码头,入境,0,0,0,0
2020-04-28,启德邮轮码头,出境,0,0,0,0
2020-04-28,港澳客轮码头,入境,0,0,0,0
2020-04-28,港澳客轮码头,出境,0,0,0,0
2020-04-28,屯门客运码头,入境,0,0,0,0
2020-04-28,屯门客运码头,出境,0,0,0,0
2020-04-29,机场,入境,814,4,15,833
2020-04-29,机场,出境,341,6,44,391
2020-04-29,高铁西九龙,入境,0,0,0,0
2020-04-29,高铁西九龙,出境,0,0,0,0
2020-04-29,红磡,入境,0,0,0,0
2020-04-29,红磡,出境,0,0,0,0
2020-04-29,罗湖,入境,0,0,0,0
2020-04-29,罗湖,出境,0,0,0,0
2020-04-29,落马洲支线,入境,0,0,0,0
2020-04-29,落马洲支线,出境,0,0,0,0
2020-04-29,港珠澳大桥,入境,24,2,0,26
2020-04-29,港珠澳大桥,出境,18,1,1,20
2020-04-29,落马洲,入境,0,0,0,0
2020-04-29,落马洲,出境,0,0,0,0
2020-04-29,文锦渡,入境,0,0,0,0
2020-04-29,文锦渡,出境,0,0,0,0
2020-04-29,沙头角,入境,0,0,0,0
2020-04-29,沙头角,出境,0,0,0,0
2020-04-29,深圳湾,入境,455,70,2,527
2020-04-29,深圳湾,出境,242,23,5,270
2020-04-29,中国客运码头,入境,0,0,0,0
2020-04-29,中国客运码头,出境,0,0,0,0
2020-04-29,港口管制,入境,0,0,0,0
2020-04-29,港口管制,出境,0,0,0,0
2020-04-29,启德邮轮码头,入境,0,0,0,0
2020-04-29,启德邮轮码头,出境,0,0,0,0
2020-04-29,港澳客轮码头,入境,0,0,0,0
2020-04-29,港澳客轮码头,出境,0,0,0,0
2020-04-29,屯门客运码头,入境,0,0,0,0
2020-04-29,屯门客运码头,出境,0,0,0,0
2020-04-30,机场,入境,747,5,48,800
2020-04-30,机场,出境,254,17,31,302
2020-04-30,高铁西九龙,入境,0,0,0,0
2020-04-30,高铁西九龙,出境,0,0,0,0
2020-04-30,红磡,入境,0,0,0,0
2020-04-30,红磡,出境,0,0,0,0
2020-04-30,罗湖,入境,0,0,0,0
2020-04-30,罗湖,出境,0,0,0,0
2020-04-30,落马洲支线,入境,0,0,0,0
2020-04-30,落马洲支线,出境,0,0,0,0
2020-04-30,港珠澳大桥,入境,37,6,2,45
2020-04-30,港珠澳大桥,出境,31,2,3,36
2020-04-30,落马洲,入境,0,0,0,0
2020-04-30,落马洲,出境,0,0,0,0
2020-04-30,文锦渡,入境,0,0,0,0
2020-04-30,文锦渡,出境,0,0,0,0
2020-04-30,沙头角,入境,0,0,0,0
2020-04-30,沙头角,出境,0,0,0,0
2020-04-30,深圳湾,入境,827,114,2,943
2020-04-30,深圳湾,出境,348,70,4,422
2020-04-30,中国客运码头,入境,0,0,0,0
2020-04-30,中国客运码头,出境,0,0,0,0
2020-04-30,港口管制,入境,0,0,0,0
2020-04-30,港口管制,出境,0,0,0,0
2020-04-30,启德邮轮码头,入境,0,0,0,0
2020-04-30,启德邮轮码头,出境,0,0,0,0
2020-04-30,港澳客轮码头,入境,0,0,0,0
2020-04-30,港澳客轮码头,出境,0,0,0,0
2020-04-30,屯门客运码头,入境,0,0,0,0
2020-04-30,屯门客运码头,出境,0,0,0,0
2020-05-01,机场,入境,837,4,24,865
2020-05-01,机场,出境,533,6,98,637
2020-05-01,高铁西九龙,入境,0,0,0,0
2020-05-01,高铁西九龙,出境,0,0,0,0
2020-05-01,红磡,入境,0,0,0,0
2020-05-01,红磡,出境,0,0,0,0
2020-05-01,罗湖,入境,0,0,0,0
2020-05-01,罗湖,出境,0,0,0,0
2020-05-01,落马洲支线,入境,0,0,0,0
2020-05-01,落马洲支线,出境,0,0,0,0
2020-05-01,港珠澳大桥,入境,35,5,1,41
2020-05-01,港珠澳大桥,出境,17,1,1,19
2020-05-01,落马洲,入境,0,0,0,0
2020-05-01,落马洲,出境,0,0,0,0
2020-05-01,文锦渡,入境,0,0,0,0
2020-05-01,文锦渡,出境,0,0,0,0
2020-05-01,沙头角,入境,0,0,0,0
2020-05-01,沙头角,出境,0,0,0,0
2020-05-01,深圳湾,入境,507,110,5,622
2020-05-01,深圳湾,出境,265,56,1,322
2020-05-01,中国客运码头,入境,0,0,0,0
2020-05-01,中国客运码头,出境,0,0,0,0
2020-05-01,港口管制,入境,0,0,0,0
2020-05-01,港口管制,出境,0,0,0,0
2020-05-01,启德邮轮码头,入境,0,0,0,0
2020-05-01,启德邮轮码头,出境,0,0,0,0
2020-05-01,港澳客轮码头,入境,0,0,0,0
2020-05-01,港澳客轮码头,出境,0,0,0,0
2020-05-01,屯门客运码头,入境,0,0,0,0
2020-05-01,屯门客运码头,出境,0,0,0,0
2020-05-02,机场,入境,452,6,39,497
2020-05-02,机场,出境,352,4,72,428
2020-05-02,高铁西九龙,入境,0,0,0,0
2020-05-02,高铁西九龙,出境,0,0,0,0
2020-05-02,红磡,入境,0,0,0,0
2020-05-02,红磡,出境,0,0,0,0
2020-05-02,罗湖,入境,0,0,0,0
2020-05-02,罗湖,出境,0,0,0,0
2020-05-02,落马洲支线,入境,0,0,0,0
2020-05-02,落马洲支线,出境,0,0,0,0
2020-05-02,港珠澳大桥,入境,34,5,0,39
2020-05-02,港珠澳大桥,出境,24,0,0,24
2020-05-02,落马洲,入境,0,0,0,0
2020-05-02,落马洲,出境,0,0,0,0
2020-05-02,文锦渡,入境,0,0,0,0
2020-05-02,文锦渡,出境,0,0,0,0
2020-05-02,沙头角,入境,0,0,0,0
2020-05-02,沙头角,出境,0,0,0,0
2020-05-02,深圳湾,入境,534,89,0,623
2020-05-02,深圳湾,出境,220,27,3,250
2020-05-02,中国客运码头,入境,0,0,0,0
2020-05-02,中国客运码头,出境,0,0,0,0
2020-05-02,港口管制,入境,0,0,0,0
2020-05-02,港口管制,出境,0,0,0,0
2020-05-02,启德邮轮码头,入境,0,0,0,0
2020-05-02,启德邮轮码头,出境,0,0,0,0
2020-05-02,港澳客轮码头,入境,0,0,0,0
2020-05-02,港澳客轮码头,出境,0,0,0,0
2020-05-02,屯门客运码头,入境,0,0,0,0
2020-05-02,屯门客运码头,出境,0,0,0,0
2020-05-03,机场,入境,713,1,26,740
2020-05-03,机场,出境,212,6,44,262
2020-05-03,高铁西九龙,入境,0,0,0,0
2020-05-03,高铁西九龙,出境,0,0,0,0
2020-05-03,红磡,入境,0,0,0,0
2020-05-03,红磡,出境,0,0,0,0
2020-05-03,罗湖,入境,0,0,0,0
2020-05-03,罗湖,出境,0,0,0,0
2020-05-03,落马洲支线,入境,0,0,0,0
2020-05-03,落马洲支线,出境,0,0,0,0
2020-05-03,港珠澳大桥,入境,38,1,7,46
2020-05-03,港珠澳大桥,出境,10,2,4,16
2020-05-03,落马洲,入境,0,0,0,0
2020-05-03,落马洲,出境,0,0,0,0
2020-05-03,文锦渡,入境,0,0,0,0
2020-05-03,文锦渡,出境,0,0,0,0
2020-05-03,沙头角,入境,0,0,0,0
2020-05-03,沙头角,出境,0,0,0,0
2020-05-03,深圳湾,入境,719,140,2,861
2020-05-03,深圳湾,出境,211,40,2,253
2020-05-03,中国客运码头,入境,0,0,0,0
2020-05-03,中国客运码头,出境,0,0,0,0
2020-05-03,港口管制,入境,0,0,0,0
2020-05-03,港口管制,出境,0,0,0,0
2020-05-03,启德邮轮码头,入境,0,0,0,0
2020-05-03,启德邮轮码头,出境,0,0,0,0
2020-05-03,港澳客轮码头,入境,0,0,0,0
2020-05-03,港澳客轮码头,出境,0,0,0,0
2020-05-03,屯门客运码头,入境,0,0,0,0
2020-05-03,屯门客运码头,出境,0,0,0,0
2020-05-04,机场,入境,770,10,19,799
2020-05-04,机场,出境,251,4,161,416
2020-05-04,高铁西九龙,入境,0,0,0,0
2020-05-04,高铁西九龙,出境,0,0,0,0
2020-05-04,红磡,入境,0,0,0,0
2020-05-04,红磡,出境,0,0,0,0
2020-05-04,罗湖,入境,0,0,0,0
2020-05-04,罗湖,出境,0,0,0,0
2020-05-04,落马洲支线,入境,0,0,0,0
2020-05-04,落马洲支线,出境,0,0,0,0
2020-05-04,港珠澳大桥,入境,50,5,11,66
2020-05-04,港珠澳大桥,出境,19,1,0,20
2020-05-04,落马洲,入境,0,0,0,0
2020-05-04,落马洲,出境,0,0,0,0
2020-05-04,文锦渡,入境,0,0,0,0
2020-05-04,文锦渡,出境,0,0,0,0
2020-05-04,沙头角,入境,0,0,0,0
2020-05-04,沙头角,出境,0,0,0,0
2020-05-04,深圳湾,入境,629,79,4,712
2020-05-04,深圳湾,出境,288,33,6,327
2020-05-04,中国客运码头,入境,0,0,0,0
2020-05-04,中国客运码头,出境,0,0,0,0
2020-05-04,港口管制,入境,0,0,0,0
2020-05-04,港口管制,出境,0,0,0,0
2020-05-04,启德邮轮码头,入境,0,0,0,0
2020-05-04,启德邮轮码头,出境,0,0,0,0
2020-05-04,港澳客轮码头,入境,0,0,0,0
2020-05-04,港澳客轮码头,出境,0,0,0,0
2020-05-04,屯门客运码头,入境,0,0,0,0
2020-05-04,屯门客运码头,出境,0,0,0,0
2020-05-05,机场,入境,372,3,11,386
2020-05-05,机场,出境,138,2,24,164
2020-05-05,高铁西九龙,入境,0,0,0,0
2020-05-05,高铁西九龙,出境,0,0,0,0
2020-05-05,红磡,入境,0,0,0,0
2020-05-05,红磡,出境,0,0,0,0
2020-05-05,罗湖,入境,0,0,0,0
2020-05-05,罗湖,出境,0,0,0,0
2020-05-05,落马洲支线,入境,0,0,0,0
2020-05-05,落马洲支线,出境,0,0,0,0
2020-05-05,港珠澳大桥,入境,49,6,2,57
2020-05-05,港珠澳大桥,出境,29,0,2,31
2020-05-05,落马洲,入境,0,0,0,0
2020-05-05,落马洲,出境,0,0,0,0
2020-05-05,文锦渡,入境,0,0,0,0
2020-05-05,文锦渡,出境,0,0,0,0
2020-05-05,沙头角,入境,0,0,0,0
2020-05-05,沙头角,出境,0,0,0,0
2020-05-05,深圳湾,入境,587,75,1,663
2020-05-05,深圳湾,出境,257,36,12,305
2020-05-05,中国客运码头,入境,0,0,0,0
2020-05-05,中国客运码头,出境,0,0,0,0
2020-05-05,港口管制,入境,0,0,0,0
2020-05-05,港口管制,出境,0,0,0,0
2020-05-05,启德邮轮码头,入境,0,0,0,0
2020-05-05,启德邮轮码头,出境,0,0,0,0
2020-05-05,港澳客轮码头,入境,0,0,0,0
2020-05-05,港澳客轮码头,出境,0,0,0,0
2020-05-05,屯门客运码头,入境,0,0,0,0
2020-05-05,屯门客运码头,出境,0,0,0,0
2020-05-06,机场,入境,496,4,13,513
2020-05-06,机场,出境,313,9,30,352
2020-05-06,高铁西九龙,入境,0,0,0,0
2020-05-06,高铁西九龙,出境,0,0,0,0
2020-05-06,红磡,入境,0,0,0,0
2020-05-06,红磡,出境,0,0,0,0
2020-05-06,罗湖,入境,0,0,0,0
2020-05-06,罗湖,出境,0,0,0,0
2020-05-06,落马洲支线,入境,0,0,0,0
2020-05-06,落马洲支线,出境,0,0,0,0
2020-05-06,港珠澳大桥,入境,53,4,6,63
2020-05-06,港珠澳大桥,出境,13,2,3,18
2020-05-06,落马洲,入境,0,0,0,0
2020-05-06,落马洲,出境,0,0,0,0
2020-05-06,文锦渡,入境,0,0,0,0
2020-05-06,文锦渡,出境,0,0,0,0
2020-05-06,沙头角,入境,0,0,0,0
2020-05-06,沙头角,出境,0,0,0,0
2020-05-06,深圳湾,入境,754,79,1,834
2020-05-06,深圳湾,出境,287,43,7,337
2020-05-06,中国客运码头,入境,0,0,0,0
2020-05-06,中国客运码头,出境,0,0,0,0
2020-05-06,港口管制,入境,0,0,0,0
2020-05-06,港口管制,出境,0,0,0,0
2020-05-06,启德邮轮码头,入境,0,0,0,0
2020-05-06,启德邮轮码头,出境,0,0,0,0
2020-05-06,港澳客轮码头,入境,0,0,0,0
2020-05-06,港澳客轮码头,出境,0,0,0,0
2020-05-06,屯门客运码头,入境,0,0,0,0
2020-05-06,屯门客运码头,出境,0,0,0,0
2020-05-07,机场,入境,301,5,5,311
2020-05-07,机场,出境,143,3,8,154
2020-05-07,高铁西九龙,入境,0,0,0,0
2020-05-07,高铁西九龙,出境,0,0,0,0
2020-05-07,红磡,入境,0,0,0,0
2020-05-07,红磡,出境,0,0,0,0
2020-05-07,罗湖,入境,0,0,0,0
2020-05-07,罗湖,出境,0,0,0,0
2020-05-07,落马洲支线,入境,0,0,0,0
2020-05-07,落马洲支线,出境,0,0,0,0
2020-05-07,港珠澳大桥,入境,52,0,2,54
2020-05-07,港珠澳大桥,出境,21,3,0,24
2020-05-07,落马洲,入境,0,0,0,0
2020-05-07,落马洲,出境,0,0,0,0
2020-05-07,文锦渡,入境,0,0,0,0
2020-05-07,文锦渡,出境,0,0,0,0
2020-05-07,沙头角,入境,0,0,0,0
2020-05-07,沙头角,出境,0,0,0,0
2020-05-07,深圳湾,入境,761,103,2,866
2020-05-07,深圳湾,出境,298,69,0,367
2020-05-07,中国客运码头,入境,0,0,0,0
2020-05-07,中国客运码头,出境,0,0,0,0
2020-05-07,港口管制,入境,0,0,0,0
2020-05-07,港口管制,出境,0,0,0,0
2020-05-07,启德邮轮码头,入境,0,0,0,0
2020-05-07,启德邮轮码头,出境,0,0,0,0
2020-05-07,港澳客轮码头,入境,0,0,0,0
2020-05-07,港澳客轮码头,出境,0,0,0,0
2020-05-07,屯门客运码头,入境,0,0,0,0
2020-05-07,屯门客运码头,出境,0,0,0,0
2020-05-08,机场,入境,1249,13,35,1297
2020-05-08,机场,出境,371,9,49,429
2020-05-08,高铁西九龙,入境,0,0,0,0
2020-05-08,高铁西九龙,出境,0,0,0,0
2020-05-08,红磡,入境,0,0,0,0
2020-05-08,红磡,出境,0,0,0,0
2020-05-08,罗湖,入境,0,0,0,0
2020-05-08,罗湖,出境,0,0,0,0
2020-05-08,落马洲支线,入境,0,0,0,0
2020-05-08,落马洲支线,出境,0,0,0,0
2020-05-08,港珠澳大桥,入境,153,7,9,169
2020-05-08,港珠澳大桥,出境,46,1,6,53
2020-05-08,落马洲,入境,0,0,0,0
2020-05-08,落马洲,出境,0,0,0,0
2020-05-08,文锦渡,入境,0,0,0,0
2020-05-08,文锦渡,出境,0,0,0,0
2020-05-08,沙头角,入境,0,0,0,0
2020-05-08,沙头角,出境,0,0,0,0
2020-05-08,深圳湾,入境,1045,137,4,1186
2020-05-08,深圳湾,出境,348,67,2,417
2020-05-08,中国客运码头,入境,0,0,0,0
2020-05-08,中国客运码头,出境,0,0,0,0
2020-05-08,港口管制,入境,0,0,0,0
2020-05-08,港口管制,出境,0,0,0,0
2020-05-08,启德邮轮码头,入境,0,0,0,0
2020-05-08,启德邮轮码头,出境,0,0,0,0
2020-05-08,港澳客轮码头,入境,0,0,0,0
2020-05-08,港澳客轮码头,出境,0,0,0,0
2020-05-08,屯门客运码头,入境,0,0,0,0
2020-05-08,屯门客运码头,出境,0,0,0,0
2020-05-09,机场,入境,560,6,63,629
2020-05-09,机场,出境,260,14,28,302
2020-05-09,高铁西九龙,入境,0,0,0,0
2020-05-09,高铁西九龙,出境,0,0,0,0
2020-05-09,红磡,入境,0,0,0,0
2020-05-09,红磡,出境,0,0,0,0
2020-05-09,罗湖,入境,0,0,0,0
2020-05-09,罗湖,出境,0,0,0,0
2020-05-09,落马洲支线,入境,0,0,0,0
2020-05-09,落马洲支线,出境,0,0,0,0
2020-05-09,港珠澳大桥,入境,144,7,4,155
2020-05-09,港珠澳大桥,出境,43,5,1,49
2020-05-09,落马洲,入境,0,0,0,0
2020-05-09,落马洲,出境,0,0,0,0
2020-05-09,文锦渡,入境,0,0,0,0
2020-05-09,文锦渡,出境,0,0,0,0
2020-05-09,沙头角,入境,0,0,0,0
2020-05-09,沙头角,出境,0,0,0,0
2020-05-09,深圳湾,入境,1056,156,5,1217
2020-05-09,深圳湾,出境,237,38,3,278
2020-05-09,中国客运码头,入境,0,0,0,0
2020-05-09,中国客运码头,出境,0,0,0,0
2020-05-09,港口管制,入境,0,0,0,0
2020-05-09,港口管制,出境,0,0,0,0
2020-05-09,启德邮轮码头,入境,0,0,0,0
2020-05-09,启德邮轮码头,出境,0,0,0,0
2020-05-09,港澳客轮码头,入境,0,0,0,0
2020-05-09,港澳客轮码头,出境,0,0,0,0
2020-05-09,屯门客运码头,入境,0,0,0,0
2020-05-09,屯门客运码头,出境,0,0,0,0
2020-05-10,机场,入境,923,7,41,971
2020-05-10,机场,出境,254,7,42,303
2020-05-10,高铁西九龙,入境,0,0,0,0
2020-05-10,高铁西九龙,出境,0,0,0,0
2020-05-10,红磡,入境,0,0,0,0
2020-05-10,红磡,出境,0,0,0,0
2020-05-10,罗湖,入境,0,0,0,0
2020-05-10,罗湖,出境,0,0,0,0
2020-05-10,落马洲支线,入境,0,0,0,0
2020-05-10,落马洲支线,出境,0,0,0,0
2020-05-10,港珠澳大桥,入境,126,6,5,137
2020-05-10,港珠澳大桥,出境,33,1,3,37
2020-05-10,落马洲,入境,0,0,0,0
2020-05-10,落马洲,出境,0,0,0,0
2020-05-10,文锦渡,入境,0,0,0,0
2020-05-10,文锦渡,出境,0,0,0,0
2020-05-10,沙头角,入境,0,0,0,0
2020-05-10,沙头角,出境,0,0,0,0
2020-05-10,深圳湾,入境,1783,201,4,1988
2020-05-10,深圳湾,出境,233,43,5,281
2020-05-10,中国客运码头,入境,0,0,0,0
2020-05-10,中国客运码头,出境,0,0,0,0
2020-05-10,港口管制,入境,0,0,0,0
2020-05-10,港口管制,出境,0,0,0,0
2020-05-10,启德邮轮码头,入境,0,0,0,0
2020-05-10,启德邮轮码头,出境,0,0,0,0
2020-05-10,港澳客轮码头,入境,0,0,0,0
2020-05-10,港澳客轮码头,出境,0,0,0,0
2020-05-10,屯门客运码头,入境,0,0,0,0
2020-05-10,屯门客运码头,出境,0,0,0,0
2020-05-11,机场,入境,797,7,30,834
2020-05-11,机场,出境,195,8,25,228
2020-05-11,高铁西九龙,入境,0,0,0,0
2020-05-11,高铁西九龙,出境,0,0,0,0
2020-05-11,红磡,入境,0,0,0,0
2020-05-11,红磡,出境,0,0,0,0
2020-05-11,罗湖,入境,0,0,0,0
2020-05-11,罗湖,出境,0,0,0,0
2020-05-11,落马洲支线,入境,0,0,0,0
2020-05-11,落马洲支线,出境,0,0,0,0
2020-05-11,港珠澳大桥,入境,167,3,7,177
2020-05-11,港珠澳大桥,出境,34,3,5,42
2020-05-11,落马洲,入境,0,0,0,0
2020-05-11,落马洲,出境,0,0,0,0
2020-05-11,文锦渡,入境,0,0,0,0
2020-05-11,文锦渡,出境,0,0,0,0
2020-05-11,沙头角,入境,0,0,0,0
2020-05-11,沙头角,出境,0,0,0,0
2020-05-11,深圳湾,入境,1886,175,6,2067
2020-05-11,深圳湾,出境,454,52,2,508
2020-05-11,中国客运码头,入境,0,0,0,0
2020-05-11,中国客运码头,出境,0,0,0,0
2020-05-11,港口管制,入境,0,0,0,0
2020-05-11,港口管制,出境,0,0,0,0
2020-05-11,启德邮轮码头,入境,0,0,0,0
2020-05-11,启德邮轮码头,出境,0,0,0,0
2020-05-11,港澳客轮码头,入境,0,0,0,0
2020-05-11,港澳客轮码头,出境,0,0,0,0
2020-05-11,屯门客运码头,入境,0,0,0,0
2020-05-11,屯门客运码头,出境,0,0,0,0
2020-05-12,机场,入境,452,5,33,490
2020-05-12,机场,出境,146,7,34,187
2020-05-12,高铁西九龙,入境,0,0,0,0
2020-05-12,高铁西九龙,出境,0,0,0,0
2020-05-12,红磡,入境,0,0,0,0
2020-05-12,红磡,出境,0,0,0,0
2020-05-12,罗湖,入境,0,0,0,0
2020-05-12,罗湖,出境,0,0,0,0
2020-05-12,落马洲支线,入境,0,0,0,0
2020-05-12,落马洲支线,出境,0,0,0,0
2020-05-12,港珠澳大桥,入境,180,6,6,192
2020-05-12,港珠澳大桥,出境,28,0,0,28
2020-05-12,落马洲,入境,0,0,0,0
2020-05-12,落马洲,出境,0,0,0,0
2020-05-12,文锦渡,入境,0,0,0,0
2020-05-12,文锦渡,出境,0,0,0,0
2020-05-12,沙头角,入境,0,0,0,0
2020-05-12,沙头角,出境,0,0,0,0
2020-05-12,深圳湾,入境,1906,184,6,2096
2020-05-12,深圳湾,出境,278,36,9,323
2020-05-12,中国客运码头,入境,0,0,0,0
2020-05-12,中国客运码头,出境,0,0,0,0
2020-05-12,港口管制,入境,0,0,0,0
2020-05-12,港口管制,出境,0,0,0,0
2020-05-12,启德邮轮码头,入境,0,0,0,0
2020-05-12,启德邮轮码头,出境,0,0,0,0
2020-05-12,港澳客轮码头,入境,0,0,0,0
2020-05-12,港澳客轮码头,出境,0,0,0,0
2020-05-12,屯门客运码头,入境,0,0,0,0
2020-05-12,屯门客运码头,出境,0,0,0,0
2020-05-13,机场,入境,600,13,24,637
2020-05-13,机场,出境,368,10,77,455
2020-05-13,高铁西九龙,入境,0,0,0,0
2020-05-13,高铁西九龙,出境,0,0,0,0
2020-05-13,红磡,入境,0,0,0,0
2020-05-13,红磡,出境,0,0,0,0
2020-05-13,罗湖,入境,0,0,0,0
2020-05-13,罗湖,出境,0,0,0,0
2020-05-13,落马洲支线,入境,0,0,0,0
2020-05-13,落马洲支线,出境,0,0,0,0
2020-05-13,港珠澳大桥,入境,118,5,1,124
2020-05-13,港珠澳大桥,出境,35,0,4,39
2020-05-13,落马洲,入境,0,0,0,0
2020-05-13,落马洲,出境,0,0,0,0
2020-05-13,文锦渡,入境,0,0,0,0
2020-05-13,文锦渡,出境,0,0,0,0
2020-05-13,沙头角,入境,0,0,0,0
2020-05-13,沙头角,出境,0,0,0,0
2020-05-13,深圳湾,入境,1149,112,8,1269
2020-05-13,深圳湾,出境,265,66,1,332
2020-05-13,中国客运码头,入境,0,0,0,0
2020-05-13,中国客运码头,出境,0,0,0,0
2020-05-13,港口管制,入境,0,0,0,0
2020-05-13,港口管制,出境,0,0,0,0
2020-05-13,启德邮轮码头,入境,0,0,0,0
2020-05-13,启德邮轮码头,出境,0,0,0,0
2020-05-13,港澳客轮码头,入境,0,0,0,0
2020-05-13,港澳客轮码头,出境,0,0,0,0
2020-05-13,屯门客运码头,入境,0,0,0,0
2020-05-13,屯门客运码头,出境,0,0,0,0
2020-05-14,机场,入境,597,3,32,632
2020-05-14,机场,出境,187,2,41,230
2020-05-14,高铁西九龙,入境,0,0,0,0
2020-05-14,高铁西九龙,出境,0,0,0,0
2020-05-14,红磡,入境,0,0,0,0
2020-05-14,红磡,出境,0,0,0,0
2020-05-14,罗湖,入境,0,0,0,0
2020-05-14,罗湖,出境,0,0,0,0
2020-05-14,落马洲支线,入境,0,0,0,0
2020-05-14,落马洲支线,出境,0,0,0,0
2020-05-14,港珠澳大桥,入境,119,5,11,135
2020-05-14,港珠澳大桥,出境,41,0,5,46
2020-05-14,落马洲,入境,0,0,0,0
2020-05-14,落马洲,出境,0,0,0,0
2020-05-14,文锦渡,入境,0,0,0,0
2020-05-14,文锦渡,出境,0,0,0,0
2020-05-14,沙头角,入境,0,0,0,0
2020-05-14,沙头角,出境,0,0,0,0
2020-05-14,深圳湾,入境,777,122,4,903
2020-05-14,深圳湾,出境,298,41,29,368
2020-05-14,中国客运码头,入境,0,0,0,0
2020-05-14,中国客运码头,出境,0,0,0,0
2020-05-14,港口管制,入境,0,0,0,0
2020-05-14,港口管制,出境,0,0,0,0
2020-05-14,启德邮轮码头,入境,0,0,0,0
2020-05-14,启德邮轮码头,出境,0,0,0,0
2020-05-14,港澳客轮码头,入境,0,0,0,0
2020-05-14,港澳客轮码头,出境,0,0,0,0
2020-05-14,屯门客运码头,入境,0,0,0,0
2020-05-14,屯门客运码头,出境,0,0,0,0
2020-05-15,机场,入境,939,3,31,973
2020-05-15,机场,出境,251,3,60,314
2020-05-15,高铁西九龙,入境,0,0,0,0
2020-05-15,高铁西九龙,出境,0,0,0,0
2020-05-15,红磡,入境,0,0,0,0
2020-05-15,红磡,出境,0,0,0,0
2020-05-15,罗湖,入境,0,0,0,0
2020-05-15,罗湖,出境,0,0,0,0
2020-05-15,落马洲支线,入境,0,0,0,0
2020-05-15,落马洲支线,出境,0,0,0,0
2020-05-15,港珠澳大桥,入境,102,9,8,119
2020-05-15,港珠澳大桥,出境,51,5,9,65
2020-05-15,落马洲,入境,0,0,0,0
2020-05-15,落马洲,出境,0,0,0,0
2020-05-15,文锦渡,入境,0,0,0,0
2020-05-15,文锦渡,出境,0,0,0,0
2020-05-15,沙头角,入境,0,0,0,0
2020-05-15,沙头角,出境,0,0,0,0
2020-05-15,深圳湾,入境,885,133,5,1023
2020-05-15,深圳湾,出境,293,55,1,349
2020-05-15,中国客运码头,入境,0,0,0,0
2020-05-15,中国客运码头,出境,0,0,0,0
2020-05-15,港口管制,入境,0,0,0,0
2020-05-15,港口管制,出境,0,0,0,0
2020-05-15,启德邮轮码头,入境,0,0,0,0
2020-05-15,启德邮轮码头,出境,0,0,0,0
2020-05-15,港澳客轮码头,入境,0,0,0,0
2020-05-15,港澳客轮码头,出境,0,0,0,0
2020-05-15,屯门客运码头,入境,0,0,0,0
2020-05-15,屯门客运码头,出境,0,0,0,0
2020-05-16,机场,入境,891,13,149,1053
2020-05-16,机场,出境,337,5,77,419
2020-05-16,高铁西九龙,入境,0,0,0,0
2020-05-16,高铁西九龙,出境,0,0,0,0
2020-05-16,红磡,入境,0,0,0,0
2020-05-16,红磡,出境,0,0,0,0
2020-05-16,罗湖,入境,0,0,0,0
2020-05-16,罗湖,出境,0,0,0,0
2020-05-16,落马洲支线,入境,0,0,0,0
2020-05-16,落马洲支线,出境,0,0,0,0
2020-05-16,港珠澳大桥,入境,80,6,7,93
2020-05-16,港珠澳大桥,出境,46,3,3,52
2020-05-16,落马洲,入境,0,0,0,0
2020-05-16,落马洲,出境,0,0,0,0
2020-05-16,文锦渡,入境,0,0,0,0
2020-05-16,文锦渡,出境,0,0,0,0
2020-05-16,沙头角,入境,0,0,0,0
2020-05-16,沙头角,出境,0,0,0,0
2020-05-16,深圳湾,入境,950,155,9,1114
2020-05-16,深圳湾,出境,311,45,3,359
2020-05-16,中国客运码头,入境,0,0,0,0
2020-05-16,中国客运码头,出境,0,0,0,0
2020-05-16,港口管制,入境,0,0,0,0
2020-05-16,港口管制,出境,0,0,0,0
2020-05-16,启德邮轮码头,入境,0,0,0,0
2020-05-16,启德邮轮码头,出境,0,0,0,0
2020-05-16,港澳客轮码头,入境,0,0,0,0
2020-05-16,港澳客轮码头,出境,0,0,0,0
2020-05-16,屯门客运码头,入境,0,0,0,0
2020-05-16,屯门客运码头,出境,0,0,0,0
2020-05-17,机场,入境,873,6,55,934
2020-05-17,机场,出境,221,7,61,289
2020-05-17,高铁西九龙,入境,0,0,0,0
2020-05-17,高铁西九龙,出境,0,0,0,0
2020-05-17,红磡,入境,0,0,0,0
2020-05-17,红磡,出境,0,0,0,0
2020-05-17,罗湖,入境,0,0,0,0
2020-05-17,罗湖,出境,0,0,0,0
2020-05-17,落马洲支线,入境,0,0,0,0
2020-05-17,落马洲支线,出境,0,0,0,0
2020-05-17,港珠澳大桥,入境,110,5,3,118
2020-05-17,港珠澳大桥,出境,30,4,1,35
2020-05-17,落马洲,入境,0,0,0,0
2020-05-17,落马洲,出境,0,0,0,0
2020-05-17,文锦渡,入境,0,0,0,0
2020-05-17,文锦渡,出境,0,0,0,0
2020-05-17,沙头角,入境,0,0,0,0
2020-05-17,沙头角,出境,0,0,0,0
2020-05-17,深圳湾,入境,1169,182,10,1361
2020-05-17,深圳湾,出境,195,40,1,236
2020-05-17,中国客运码头,入境,0,0,0,0
2020-05-17,中国客运码头,出境,0,0,0,0
2020-05-17,港口管制,入境,0,0,0,0
2020-05-17,港口管制,出境,0,0,0,0
2020-05-17,启德邮轮码头,入境,0,0,0,0
2020-05-17,启德邮轮码头,出境,0,0,0,0
2020-05-17,港澳客轮码头,入境,0,0,0,0
2020-05-17,港澳客轮码头,出境,0,0,0,0
2020-05-17,屯门客运码头,入境,0,0,0,0
2020-05-17,屯门客运码头,出境,0,0,0,0
2020-05-18,机场,入境,997,6,39,1042
2020-05-18,机场,出境,261,9,62,332
2020-05-18,高铁西九龙,入境,0,0,0,0
2020-05-18,高铁西九龙,出境,0,0,0,0
2020-05-18,红磡,入境,0,0,0,0
2020-05-18,红磡,出境,0,0,0,0
2020-05-18,罗湖,入境,0,0,0,0
2020-05-18,罗湖,出境,0,0,0,0
2020-05-18,落马洲支线,入境,0,0,0,0
2020-05-18,落马洲支线,出境,0,0,0,0
2020-05-18,港珠澳大桥,入境,84,6,14,104
2020-05-18,港珠澳大桥,出境,26,0,2,28
2020-05-18,落马洲,入境,0,0,0,0
2020-05-18,落马洲,出境,0,0,0,0
2020-05-18,文锦渡,入境,0,0,0,0
2020-05-18,文锦渡,出境,0,0,0,0
2020-05-18,沙头角,入境,0,0,0,0
2020-05-18,沙头角,出境,0,0,0,0
2020-05-18,深圳湾,入境,938,125,13,1076
2020-05-18,深圳湾,出境,348,39,2,389
2020-05-18,中国客运码头,入境,0,0,0,0
2020-05-18,中国客运码头,出境,0,0,0,0
2020-05-18,港口管制,入境,0,0,0,0
2020-05-18,港口管制,出境,0,0,0,0
2020-05-18,启德邮轮码头,入境,0,0,0,0
2020-05-18,启德邮轮码头,出境,0,0,0,0
2020-05-18,港澳客轮码头,入境,0,0,0,0
2020-05-18,港澳客轮码头,出境,0,0,0,0
2020-05-18,屯门客运码头,入境,0,0,0,0
2020-05-18,屯门客运码头,出境,0,0,0,0
2020-05-19,机场,入境,385,0,14,399
2020-05-19,机场,出境,144,2,18,164
2020-05-19,高铁西九龙,入境,0,0,0,0
2020-05-19,高铁西九龙,出境,0,0,0,0
2020-05-19,红磡,入境,0,0,0,0
2020-05-19,红磡,出境,0,0,0,0
2020-05-19,罗湖,入境,0,0,0,0
2020-05-19,罗湖,出境,0,0,0,0
2020-05-19,落马洲支线,入境,0,0,0,0
2020-05-19,落马洲支线,出境,0,0,0,0
2020-05-19,港珠澳大桥,入境,68,5,10,83
2020-05-19,港珠澳大桥,出境,20,1,1,22
2020-05-19,落马洲,入境,0,0,0,0
2020-05-19,落马洲,出境,0,0,0,0
2020-05-19,文锦渡,入境,0,0,0,0
2020-05-19,文锦渡,出境,0,0,0,0
2020-05-19,沙头角,入境,0,0,0,0
2020-05-19,沙头角,出境,0,0,0,0
2020-05-19,深圳湾,入境,889,115,8,1012
2020-05-19,深圳湾,出境,454,37,5,496
2020-05-19,中国客运码头,入境,0,0,0,0
2020-05-19,中国客运码头,出境,0,0,0,0
2020-05-19,港口管制,入境,0,0,0,0
2020-05-19,港口管制,出境,0,0,0,0
2020-05-19,启德邮轮码头,入境,0,0,0,0
2020-05-19,启德邮轮码头,出境,0,0,0,0
2020-05-19,港澳客轮码头,入境,0,0,0,0
2020-05-19,港澳客轮码头,出境,0,0,0,0
2020-05-19,屯门客运码头,入境,0,0,0,0
2020-05-19,屯门客运码头,出境,0,0,0,0
2020-05-20,机场,入境,787,5,20,812
2020-05-20,机场,出境,230,8,26,264
2020-05-20,高铁西九龙,入境,0,0,0,0
2020-05-20,高铁西九龙,出境,0,0,0,0
2020-05-20,红磡,入境,0,0,0,0
2020-05-20,红磡,出境,0,0,0,0
2020-05-20,罗湖,入境,0,0,0,0
2020-05-20,罗湖,出境,0,0,0,0
2020-05-20,落马洲支线,入境,0,0,0,0
2020-05-20,落马洲支线,出境,0,0,0,0
2020-05-20,港珠澳大桥,入境,70,9,6,85
2020-05-20,港珠澳大桥,出境,22,3,1,26
2020-05-20,落马洲,入境,0,0,0,0
2020-05-20,落马洲,出境,0,0,0,0
2020-05-20,文锦渡,入境,0,0,0,0
2020-05-20,文锦渡,出境,0,0,0,0
2020-05-20,沙头角,入境,0,0,0,0
2020-05-20,沙头角,出境,0,0,0,0
2020-05-20,深圳湾,入境,1019,135,13,1167
2020-05-20,深圳湾,出境,262,41,1,304
2020-05-20,中国客运码头,入境,0,0,0,0
2020-05-20,中国客运码头,出境,0,0,0,0
2020-05-20,港口管制,入境,0,0,0,0
2020-05-20,港口管制,出境,0,0,0,0
2020-05-20,启德邮轮码头,入境,0,0,0,0
2020-05-20,启德邮轮码头,出境,0,0,0,0
2020-05-20,港澳客轮码头,入境,0,0,0,0
2020-05-20,港澳客轮码头,出境,0,0,0,0
2020-05-20,屯门客运码头,入境,0,0,0,0
2020-05-20,屯门客运码头,出境,0,0,0,0
2020-05-21,机场,入境,474,8,30,512
2020-05-21,机场,出境,147,8,32,187
2020-05-21,高铁西九龙,入境,0,0,0,0
2020-05-21,高铁西九龙,出境,0,0,0,0
2020-05-21,红磡,入境,0,0,0,0
2020-05-21,红磡,出境,0,0,0,0
2020-05-21,罗湖,入境,0,0,0,0
2020-05-21,罗湖,出境,0,0,0,0
2020-05-21,落马洲支线,入境,0,0,0,0
2020-05-21,落马洲支线,出境,0,0,0,0
2020-05-21,港珠澳大桥,入境,106,4,5,115
2020-05-21,港珠澳大桥,出境,23,1,2,26
2020-05-21,落马洲,入境,0,0,0,0
2020-05-21,落马洲,出境,0,0,0,0
2020-05-21,文锦渡,入境,0,0,0,0
2020-05-21,文锦渡,出境,0,0,0,0
2020-05-21,沙头角,入境,0,0,0,0
2020-05-21,沙头角,出境,0,0,0,0
2020-05-21,深圳湾,入境,1121,127,9,1257
2020-05-21,深圳湾,出境,256,79,1,336
2020-05-21,中国客运码头,入境,0,0,0,0
2020-05-21,中国客运码头,出境,0,0,0,0
2020-05-21,港口管制,入境,0,0,0,0
2020-05-21,港口管制,出境,0,0,0,0
2020-05-21,启德邮轮码头,入境,0,0,0,0
2020-05-21,启德邮轮码头,出境,0,0,0,0
2020-05-21,港澳客轮码头,入境,0,0,0,0
2020-05-21,港澳客轮码头,出境,0,0,0,0
2020-05-21,屯门客运码头,入境,0,0,0,0
2020-05-21,屯门客运码头,出境,0,0,0,0
2020-05-22,机场,入境,1089,7,31,1127
2020-05-22,机场,出境,336,4,55,395
2020-05-22,高铁西九龙,入境,0,0,0,0
2020-05-22,高铁西九龙,出境,0,0,0,0
2020-05-22,红磡,入境,0,0,0,0
2020-05-22,红磡,出境,0,0,0,0
2020-05-22,罗湖,入境,0,0,0,0
2020-05-22,罗湖,出境,0,0,0,0
2020-05-22,落马洲支线,入境,0,0,0,0
2020-05-22,落马洲支线,出境,0,0,0,0
2020-05-22,港珠澳大桥,入境,69,4,4,77
2020-05-22,港珠澳大桥,出境,31,1,1,33
2020-05-22,落马洲,入境,0,0,0,0
2020-05-22,落马洲,出境,0,0,0,0
2020-05-22,文锦渡,入境,0,0,0,0
2020-05-22,文锦渡,出境,0,0,0,0
2020-05-22,沙头角,入境,0,0,0,0
2020-05-22,沙头角,出境,0,0,0,0
2020-05-22,深圳湾,入境,1121,154,17,1292
2020-05-22,深圳湾,出境,300,70,1,371
2020-05-22,中国客运码头,入境,0,0,0,0
2020-05-22,中国客运码头,出境,0,0,0,0
2020-05-22,港口管制,入境,0,0,0,0
2020-05-22,港口管制,出境,0,0,0,0
2020-05-22,启德邮轮码头,入境,0,0,0,0
2020-05-22,启德邮轮码头,出境,0,0,0,0
2020-05-22,港澳客轮码头,入境,0,0,0,0
2020-05-22,港澳客轮码头,出境,0,0,0,0
2020-05-22,屯门客运码头,入境,0,0,0,0
2020-05-22,屯门客运码头,出境,0,0,0,0
2020-05-23,机场,入境,534,5,102,641
2020-05-23,机场,出境,202,12,35,249
2020-05-23,高铁西九龙,入境,0,0,0,0
2020-05-23,高铁西九龙,出境,0,0,0,0
2020-05-23,红磡,入境,0,0,0,0
2020-05-23,红磡,出境,0,0,0,0
2020-05-23,罗湖,入境,0,0,0,0
2020-05-23,罗湖,出境,0,0,0,0
2020-05-23,落马洲支线,入境,0,0,0,0
2020-05-23,落马洲支线,出境,0,0,0,0
2020-05-23,港珠澳大桥,入境,118,12,3,133
2020-05-23,港珠澳大桥,出境,10,1,6,17
2020-05-23,落马洲,入境,0,0,0,0
2020-05-23,落马洲,出境,0,0,0,0
2020-05-23,文锦渡,入境,0,0,0,0
2020-05-23,文锦渡,出境,0,0,0,0
2020-05-23,沙头角,入境,0,0,0,0
2020-05-23,沙头角,出境,0,0,0,0
2020-05-23,深圳湾,入境,1802,270,11,2083
2020-05-23,深圳湾,出境,210,39,11,260
2020-05-23,中国客运码头,入境,0,0,0,0
2020-05-23,中国客运码头,出境,0,0,0,0
2020-05-23,港口管制,入境,0,0,0,0
2020-05-23,港口管制,出境,0,0,0,0
2020-05-23,启德邮轮码头,入境,0,0,0,0
2020-05-23,启德邮轮码头,出境,0,0,0,0
2020-05-23,港澳客轮码头,入境,0,0,0,0
2020-05-23,港澳客轮码头,出境,0,0,0,0
2020-05-23,屯门客运码头,入境,0,0,0,0
2020-05-23,屯门客运码头,出境,0,0,0,0
2020-05-24,机场,入境,1048,10,38,1096
2020-05-24,机场,出境,237,9,40,286
2020-05-24,高铁西九龙,入境,0,0,0,0
2020-05-24,高铁西九龙,出境,0,0,0,0
2020-05-24,红磡,入境,0,0,0,0
2020-05-24,红磡,出境,0,0,0,0
2020-05-24,罗湖,入境,0,0,0,0
2020-05-24,罗湖,出境,0,0,0,0
2020-05-24,落马洲支线,入境,0,0,0,0
2020-05-24,落马洲支线,出境,0,0,0,0
2020-05-24,港珠澳大桥,入境,123,15,2,140
2020-05-24,港珠澳大桥,出境,27,0,2,29
2020-05-24,落马洲,入境,0,0,0,0
2020-05-24,落马洲,出境,0,0,0,0
2020-05-24,文锦渡,入境,0,0,0,0
2020-05-24,文锦渡,出境,0,0,0,0
2020-05-24,沙头角,入境,0,0,0,0
2020-05-24,沙头角,出境,0,0,0,0
2020-05-24,深圳湾,入境,2458,439,14,2911
2020-05-24,深圳湾,出境,210,35,3,248
2020-05-24,中国客运码头,入境,0,0,0,0
2020-05-24,中国客运码头,出境,0,0,0,0
2020-05-24,港口管制,入境,0,0,0,0
2020-05-24,港口管制,出境,0,0,0,0
2020-05-24,启德邮轮码头,入境,0,0,0,0
2020-05-24,启德邮轮码头,出境,0,0,0,0
2020-05-24,港澳客轮码头,入境,0,0,0,0
2020-05-24,港澳客轮码头,出境,0,0,0,0
2020-05-24,屯门客运码头,入境,0,0,0,0
2020-05-24,屯门客运码头,出境,0,0,0,0
2020-05-25,机场,入境,673,6,46,725
2020-05-25,机场,出境,156,4,23,183
2020-05-25,高铁西九龙,入境,0,0,0,0
2020-05-25,高铁西九龙,出境,0,0,0,0
2020-05-25,红磡,入境,0,0,0,0
2020-05-25,红磡,出境,0,0,0,0
2020-05-25,罗湖,入境,0,0,0,0
2020-05-25,罗湖,出境,0,0,0,0
2020-05-25,落马洲支线,入境,0,0,0,0
2020-05-25,落马洲支线,出境,0,0,0,0
2020-05-25,港珠澳大桥,入境,99,8,8,115
2020-05-25,港珠澳大桥,出境,48,0,3,51
2020-05-25,落马洲,入境,0,0,0,0
2020-05-25,落马洲,出境,0,0,0,0
2020-05-25,文锦渡,入境,0,0,0,0
2020-05-25,文锦渡,出境,0,0,0,0
2020-05-25,沙头角,入境,0,0,0,0
2020-05-25,沙头角,出境,0,0,0,0
2020-05-25,深圳湾,入境,1469,255,6,1730
2020-05-25,深圳湾,出境,376,18,6,400
2020-05-25,中国客运码头,入境,0,0,0,0
2020-05-25,中国客运码头,出境,0,0,0,0
2020-05-25,港口管制,入境,0,0,0,0
2020-05-25,港口管制,出境,0,0,0,0
2020-05-25,启德邮轮码头,入境,0,0,0,0
2020-05-25,启德邮轮码头,出境,0,0,0,0
2020-05-25,港澳客轮码头,入境,0,0,0,0
2020-05-25,港澳客轮码头,出境,0,0,0,0
2020-05-25,屯门客运码头,入境,0,0,0,0
2020-05-25,屯门客运码头,出境,0,0,0,0
2020-05-26,机场,入境,543,2,37,582
2020-05-26,机场,出境,252,3,53,308
2020-05-26,高铁西九龙,入境,0,0,0,0
2020-05-26,高铁西九龙,出境,0,0,0,0
2020-05-26,红磡,入境,0,0,0,0
2020-05-26,红磡,出境,0,0,0,0
2020-05-26,罗湖,入境,0,0,0,0
2020-05-26,罗湖,出境,0,0,0,0
2020-05-26,落马洲支线,入境,0,0,0,0
2020-05-26,落马洲支线,出境,0,0,0,0
2020-05-26,港珠澳大桥,入境,60,11,8,79
2020-05-26,港珠澳大桥,出境,23,0,2,25
2020-05-26,落马洲,入境,0,0,0,0
2020-05-26,落马洲,出境,0,0,0,0
2020-05-26,文锦渡,入境,0,0,0,0
2020-05-26,文锦渡,出境,0,0,0,0
2020-05-26,沙头角,入境,0,0,0,0
2020-05-26,沙头角,出境,0,0,0,0
2020-05-26,深圳湾,入境,790,142,12,944
2020-05-26,深圳湾,出境,213,31,2,246
2020-05-26,中国客运码头,入境,0,0,0,0
2020-05-26,中国客运码头,出境,0,0,0,0
2020-05-26,港口管制,入境,0,0,0,0
2020-05-26,港口管制,出境,0,0,0,0
2020-05-26,启德邮轮码头,入境,0,0,0,0
2020-05-26,启德邮轮码头,出境,0,0,0,0
2020-05-26,港澳客轮码头,入境,0,0,0,0
2020-05-26,港澳客轮码头,出境,0,0,0,0
2020-05-26,屯门客运码头,入境,0,0,0,0
2020-05-26,屯门客运码头,出境,0,0,0,0
2020-05-27,机场,入境,485,4,21,510
2020-05-27,机场,出境,331,9,149,489
2020-05-27,高铁西九龙,入境,0,0,0,0
2020-05-27,高铁西九龙,出境,0,0,0,0
2020-05-27,红磡,入境,0,0,0,0
2020-05-27,红磡,出境,0,0,0,0
2020-05-27,罗湖,入境,0,0,0,0
2020-05-27,罗湖,出境,0,0,0,0
2020-05-27,落马洲支线,入境,0,0,0,0
2020-05-27,落马洲支线,出境,0,0,0,0
2020-05-27,港珠澳大桥,入境,51,9,5,65
2020-05-27,港珠澳大桥,出境,17,0,0,17
2020-05-27,落马洲,入境,0,0,0,0
2020-05-27,落马洲,出境,0,0,0,0
2020-05-27,文锦渡,入境,0,0,0,0
2020-05-27,文锦渡,出境,0,0,0,0
2020-05-27,沙头角,入境,0,0,0,0
2020-05-27,沙头角,出境,0,0,0,0
2020-05-27,深圳湾,入境,694,107,4,805
2020-05-27,深圳湾,出境,247,34,0,281
2020-05-27,中国客运码头,入境,0,0,0,0
2020-05-27,中国客运码头,出境,0,0,0,0
2020-05-27,港口管制,入境,0,0,0,0
2020-05-27,港口管制,出境,0,0,0,0
2020-05-27,启德邮轮码头,入境,0,0,0,0
2020-05-27,启德邮轮码头,出境,0,0,0,0
2020-05-27,港澳客轮码头,入境,0,0,0,0
2020-05-27,港澳客轮码头,出境,0,0,0,0
2020-05-27,屯门客运码头,入境,0,0,0,0
2020-05-27,屯门客运码头,出境,0,0,0,0
2020-05-28,机场,入境,661,2,29,692
2020-05-28,机场,出境,195,7,71,273
2020-05-28,高铁西九龙,入境,0,0,0,0
2020-05-28,高铁西九龙,出境,0,0,0,0
2020-05-28,红磡,入境,0,0,0,0
2020-05-28,红磡,出境,0,0,0,0
2020-05-28,罗湖,入境,0,0,0,0
2020-05-28,罗湖,出境,0,0,0,0
2020-05-28,落马洲支线,入境,0,0,0,0
2020-05-28,落马洲支线,出境,0,0,0,0
2020-05-28,港珠澳大桥,入境,39,0,41,80
2020-05-28,港珠澳大桥,出境,17,0,0,17
2020-05-28,落马洲,入境,0,0,0,0
2020-05-28,落马洲,出境,0,0,0,0
2020-05-28,文锦渡,入境,0,0,0,0
2020-05-28,文锦渡,出境,0,0,0,0
2020-05-28,沙头角,入境,0,0,0,0
2020-05-28,沙头角,出境,0,0,0,0
2020-05-28,深圳湾,入境,676,114,10,800
2020-05-28,深圳湾,出境,216,27,2,245
2020-05-28,中国客运码头,入境,0,0,0,0
2020-05-28,中国客运码头,出境,0,0,0,0
2020-05-28,港口管制,入境,0,0,0,0
2020-05-28,港口管制,出境,0,0,0,0
2020-05-28,启德邮轮码头,入境,0,0,0,0
2020-05-28,启德邮轮码头,出境,0,0,0,0
2020-05-28,港澳客轮码头,入境,0,0,0,0
2020-05-28,港澳客轮码头,出境,0,0,0,0
2020-05-28,屯门客运码头,入境,0,0,0,0
2020-05-28,屯门客运码头,出境,0,0,0,0
2020-05-29,机场,入境,923,4,22,949
2020-05-29,机场,出境,264,2,65,331
2020-05-29,高铁西九龙,入境,0,0,0,0
2020-05-29,高铁西九龙,出境,0,0,0,0
2020-05-29,红磡,入境,0,0,0,0
2020-05-29,红磡,出境,0,0,0,0
2020-05-29,罗湖,入境,0,0,0,0
2020-05-29,罗湖,出境,0,0,0,0
2020-05-29,落马洲支线,入境,0,0,0,0
2020-05-29,落马洲支线,出境,0,0,0,0
2020-05-29,港珠澳大桥,入境,71,4,15,90
2020-05-29,港珠澳大桥,出境,13,0,3,16
2020-05-29,落马洲,入境,0,0,0,0
2020-05-29,落马洲,出境,0,0,0,0
2020-05-29,文锦渡,入境,0,0,0,0
2020-05-29,文锦渡,出境,0,0,0,0
2020-05-29,沙头角,入境,0,0,0,0
2020-05-29,沙头角,出境,0,0,0,0
2020-05-29,深圳湾,入境,695,106,8,809
2020-05-29,深圳湾,出境,209,24,53,286
2020-05-29,中国客运码头,入境,0,0,0,0
2020-05-29,中国客运码头,出境,0,0,0,0
2020-05-29,港口管制,入境,0,0,0,0
2020-05-29,港口管制,出境,0,0,0,0
2020-05-29,启德邮轮码头,入境,0,0,0,0
2020-05-29,启德邮轮码头,出境,0,0,0,0
2020-05-29,港澳客轮码头,入境,0,0,0,0
2020-05-29,港澳客轮码头,出境,0,0,0,0
2020-05-29,屯门客运码头,入境,0,0,0,0
2020-05-29,屯门客运码头,出境,0,0,0,0
2020-05-30,机场,入境,599,7,35,641
2020-05-30,机场,出境,414,7,48,469
2020-05-30,高铁西九龙,入境,0,0,0,0
2020-05-30,高铁西九龙,出境,0,0,0,0
2020-05-30,红磡,入境,0,0,0,0
2020-05-30,红磡,出境,0,0,0,0
2020-05-30,罗湖,入境,0,0,0,0
2020-05-30,罗湖,出境,0,0,0,0
2020-05-30,落马洲支线,入境,0,0,0,0
2020-05-30,落马洲支线,出境,0,0,0,0
2020-05-30,港珠澳大桥,入境,57,5,2,64
2020-05-30,港珠澳大桥,出境,16,1,1,18
2020-05-30,落马洲,入境,0,0,0,0
2020-05-30,落马洲,出境,0,0,0,0
2020-05-30,文锦渡,入境,0,0,0,0
2020-05-30,文锦渡,出境,0,0,0,0
2020-05-30,沙头角,入境,0,0,0,0
2020-05-30,沙头角,出境,0,0,0,0
2020-05-30,深圳湾,入境,985,149,12,1146
2020-05-30,深圳湾,出境,133,37,45,215
2020-05-30,中国客运码头,入境,0,0,0,0
2020-05-30,中国客运码头,出境,0,0,0,0
2020-05-30,港口管制,入境,0,0,0,0
2020-05-30,港口管制,出境,0,0,0,0
2020-05-30,启德邮轮码头,入境,0,0,0,0
2020-05-30,启德邮轮码头,出境,0,0,0,0
2020-05-30,港澳客轮码头,入境,0,0,0,0
2020-05-30,港澳客轮码头,出境,0,0,0,0
2020-05-30,屯门客运码头,入境,0,0,0,0
2020-05-30,屯门客运码头,出境,0,0,0,0
2020-05-31,机场,入境,839,8,41,888
2020-05-31,机场,出境,191,4,38,233
2020-05-31,高铁西九龙,入境,0,0,0,0
2020-05-31,高铁西九龙,出境,0,0,0,0
2020-05-31,红磡,入境,0,0,0,0
2020-05-31,红磡,出境,0,0,0,0
2020-05-31,罗湖,入境,0,0,0,0
2020-05-31,罗湖,出境,0,0,0,0
2020-05-31,落马洲支线,入境,0,0,0,0
2020-05-31,落马洲支线,出境,0,0,0,0
2020-05-31,港珠澳大桥,入境,83,11,6,100
2020-05-31,港珠澳大桥,出境,17,0,0,17
2020-05-31,落马洲,入境,0,0,0,0
2020-05-31,落马洲,出境,0,0,0,0
2020-05-31,文锦渡,入境,0,0,0,0
2020-05-31,文锦渡,出境,0,0,0,0
2020-05-31,沙头角,入境,0,0,0,0
2020-05-31,沙头角,出境,0,0,0,0
2020-05-31,深圳湾,入境,1304,278,11,1593
2020-05-31,深圳湾,出境,156,21,17,194
2020-05-31,中国客运码头,入境,0,0,0,0
2020-05-31,中国客运码头,出境,0,0,0,0
2020-05-31,港口管制,入境,0,0,0,0
2020-05-31,港口管制,出境,0,0,0,0
2020-05-31,启德邮轮码头,入境,0,0,0,0
2020-05-31,启德邮轮码头,出境,0,0,0,0
2020-05-31,港澳客轮码头,入境,0,0,0,0
2020-05-31,港澳客轮码头,出境,0,0,0,0
2020-05-31,屯门客运码头,入境,0,0,0,0
2020-05-31,屯门客运码头,出境,0,0,0,0
2020-06-01,机场,入境,760,9,61,830
2020-06-01,机场,出境,253,1,40,294
2020-06-01,高铁西九龙,入境,0,0,0,0
2020-06-01,高铁西九龙,出境,0,0,0,0
2020-06-01,红磡,入境,0,0,0,0
2020-06-01,红磡,出境,0,0,0,0
2020-06-01,罗湖,入境,0,0,0,0
2020-06-01,罗湖,出境,0,0,0,0
2020-06-01,落马洲支线,入境,0,0,0,0
2020-06-01,落马洲支线,出境,0,0,0,0
2020-06-01,港珠澳大桥,入境,86,10,4,100
2020-06-01,港珠澳大桥,出境,40,3,3,46
2020-06-01,落马洲,入境,0,0,0,0
2020-06-01,落马洲,出境,0,0,0,0
2020-06-01,文锦渡,入境,0,0,0,0
2020-06-01,文锦渡,出境,0,0,0,0
2020-06-01,沙头角,入境,0,0,0,0
2020-06-01,沙头角,出境,0,0,0,0
2020-06-01,深圳湾,入境,984,166,15,1165
2020-06-01,深圳湾,出境,357,25,9,391
2020-06-01,中国客运码头,入境,0,0,0,0
2020-06-01,中国客运码头,出境,0,0,0,0
2020-06-01,港口管制,入境,0,0,0,0
2020-06-01,港口管制,出境,0,0,0,0
2020-06-01,启德邮轮码头,入境,0,0,0,0
2020-06-01,启德邮轮码头,出境,0,0,0,0
2020-06-01,港澳客轮码头,入境,0,0,0,0
2020-06-01,港澳客轮码头,出境,0,0,0,0
2020-06-01,屯门客运码头,入境,0,0,0,0
2020-06-01,屯门客运码头,出境,0,0,0,0
2020-06-02,机场,入境,1150,4,52,1206
2020-06-02,机场,出境,367,2,110,479
2020-06-02,高铁西九龙,入境,0,0,0,0
2020-06-02,高铁西九龙,出境,0,0,0,0
2020-06-02,红磡,入境,0,0,0,0
2020-06-02,红磡,出境,0,0,0,0
2020-06-02,罗湖,入境,0,0,0,0
2020-06-02,罗湖,出境,0,0,0,0
2020-06-02,落马洲支线,入境,0,0,0,0
2020-06-02,落马洲支线,出境,0,0,0,0
2020-06-02,港珠澳大桥,入境,70,4,4,78
2020-06-02,港珠澳大桥,出境,32,1,3,36
2020-06-02,落马洲,入境,0,0,0,0
2020-06-02,落马洲,出境,0,0,0,0
2020-06-02,文锦渡,入境,0,0,0,0
2020-06-02,文锦渡,出境,0,0,0,0
2020-06-02,沙头角,入境,0,0,0,0
2020-06-02,沙头角,出境,0,0,0,0
2020-06-02,深圳湾,入境,576,108,17,701
2020-06-02,深圳湾,出境,267,30,4,301
2020-06-02,中国客运码头,入境,0,0,0,0
2020-06-02,中国客运码头,出境,0,0,0,0
2020-06-02,港口管制,入境,0,0,0,0
2020-06-02,港口管制,出境,0,0,0,0
2020-06-02,启德邮轮码头,入境,0,0,0,0
2020-06-02,启德邮轮码头,出境,0,0,0,0
2020-06-02,港澳客轮码头,入境,0,0,0,0
2020-06-02,港澳客轮码头,出境,0,0,0,0
2020-06-02,屯门客运码头,入境,0,0,0,0
2020-06-02,屯门客运码头,出境,0,0,0,0
2020-06-03,机场,入境,918,5,40,963
2020-06-03,机场,出境,404,12,120,536
2020-06-03,高铁西九龙,入境,0,0,0,0
2020-06-03,高铁西九龙,出境,0,0,0,0
2020-06-03,红磡,入境,0,0,0,0
2020-06-03,红磡,出境,0,0,0,0
2020-06-03,罗湖,入境,0,0,0,0
2020-06-03,罗湖,出境,0,0,0,0
2020-06-03,落马洲支线,入境,0,0,0,0
2020-06-03,落马洲支线,出境,0,0,0,0
2020-06-03,港珠澳大桥,入境,97,6,4,107
2020-06-03,港珠澳大桥,出境,64,0,2,66
2020-06-03,落马洲,入境,0,0,0,0
2020-06-03,落马洲,出境,0,0,0,0
2020-06-03,文锦渡,入境,0,0,0,0
2020-06-03,文锦渡,出境,0,0,0,0
2020-06-03,沙头角,入境,0,0,0,0
2020-06-03,沙头角,出境,0,0,0,0
2020-06-03,深圳湾,入境,1147,196,6,1349
2020-06-03,深圳湾,出境,609,88,2,699
2020-06-03,中国客运码头,入境,0,0,0,0
2020-06-03,中国客运码头,出境,0,0,0,0
2020-06-03,港口管制,入境,0,0,0,0
2020-06-03,港口管制,出境,0,0,0,0
2020-06-03,启德邮轮码头,入境,0,0,0,0
2020-06-03,启德邮轮码头,出境,0,0,0,0
2020-06-03,港澳客轮码头,入境,0,0,0,0
2020-06-03,港澳客轮码头,出境,0,0,0,0
2020-06-03,屯门客运码头,入境,0,0,0,0
2020-06-03,屯门客运码头,出境,0,0,0,0
2020-06-04,机场,入境,952,6,36,994
2020-06-04,机场,出境,440,5,80,525
2020-06-04,高铁西九龙,入境,0,0,0,0
2020-06-04,高铁西九龙,出境,0,0,0,0
2020-06-04,红磡,入境,0,0,0,0
2020-06-04,红磡,出境,0,0,0,0
2020-06-04,罗湖,入境,0,0,0,0
2020-06-04,罗湖,出境,0,0,0,0
2020-06-04,落马洲支线,入境,0,0,0,0
2020-06-04,落马洲支线,出境,0,0,0,0
2020-06-04,港珠澳大桥,入境,78,11,10,99
2020-06-04,港珠澳大桥,出境,74,3,8,85
2020-06-04,落马洲,入境,0,0,0,0
2020-06-04,落马洲,出境,0,0,0,0
2020-06-04,文锦渡,入境,0,0,0,0
2020-06-04,文锦渡,出境,0,0,0,0
2020-06-04,沙头角,入境,0,0,0,0
2020-06-04,沙头角,出境,0,0,0,0
2020-06-04,深圳湾,入境,1365,205,9,1579
2020-06-04,深圳湾,出境,820,111,8,939
2020-06-04,中国客运码头,入境,0,0,0,0
2020-06-04,中国客运码头,出境,0,0,0,0
2020-06-04,港口管制,入境,0,0,0,0
2020-06-04,港口管制,出境,0,0,0,0
2020-06-04,启德邮轮码头,入境,0,0,0,0
2020-06-04,启德邮轮码头,出境,0,0,0,0
2020-06-04,港澳客轮码头,入境,0,0,0,0
2020-06-04,港澳客轮码头,出境,0,0,0,0
2020-06-04,屯门客运码头,入境,0,0,0,0
2020-06-04,屯门客运码头,出境,0,0,0,0
2020-06-05,机场,入境,1073,4,42,1119
2020-06-05,机场,出境,633,10,78,721
2020-06-05,高铁西九龙,入境,0,0,0,0
2020-06-05,高铁西九龙,出境,0,0,0,0
2020-06-05,红磡,入境,0,0,0,0
2020-06-05,红磡,出境,0,0,0,0
2020-06-05,罗湖,入境,0,0,0,0
2020-06-05,罗湖,出境,0,0,0,0
2020-06-05,落马洲支线,入境,0,0,0,0
2020-06-05,落马洲支线,出境,0,0,0,0
2020-06-05,港珠澳大桥,入境,124,7,9,140
2020-06-05,港珠澳大桥,出境,65,9,3,77
2020-06-05,落马洲,入境,0,0,0,0
2020-06-05,落马洲,出境,0,0,0,0
2020-06-05,文锦渡,入境,0,0,0,0
2020-06-05,文锦渡,出境,0,0,0,0
2020-06-05,沙头角,入境,0,0,0,0
2020-06-05,沙头角,出境,0,0,0,0
2020-06-05,深圳湾,入境,1378,223,13,1614
2020-06-05,深圳湾,出境,829,120,14,963
2020-06-05,中国客运码头,入境,0,0,0,0
2020-06-05,中国客运码头,出境,0,0,0,0
2020-06-05,港口管制,入境,0,0,0,0
2020-06-05,港口管制,出境,0,0,0,0
2020-06-05,启德邮轮码头,入境,0,0,0,0
2020-06-05,启德邮轮码头,出境,0,0,0,0
2020-06-05,港澳客轮码头,入境,0,0,0,0
2020-06-05,港澳客轮码头,出境,0,0,0,0
2020-06-05,屯门客运码头,入境,0,0,0,0
2020-06-05,屯门客运码头,出境,0,0,0,0
2020-06-06,机场,入境,527,7,46,580
2020-06-06,机场,出境,390,22,186,598
2020-06-06,高铁西九龙,入境,0,0,0,0
2020-06-06,高铁西九龙,出境,0,0,0,0
2020-06-06,红磡,入境,0,0,0,0
2020-06-06,红磡,出境,0,0,0,0
2020-06-06,罗湖,入境,0,0,0,0
2020-06-06,罗湖,出境,0,0,0,0
2020-06-06,落马洲支线,入境,0,0,0,0
2020-06-06,落马洲支线,出境,0,0,0,0
2020-06-06,港珠澳大桥,入境,115,14,4,133
2020-06-06,港珠澳大桥,出境,56,4,8,68
2020-06-06,落马洲,入境,0,0,0,0
2020-06-06,落马洲,出境,0,0,0,0
2020-06-06,文锦渡,入境,0,0,0,0
2020-06-06,文锦渡,出境,0,0,0,0
2020-06-06,沙头角,入境,0,0,0,0
2020-06-06,沙头角,出境,0,0,0,0
2020-06-06,深圳湾,入境,1368,262,14,1644
2020-06-06,深圳湾,出境,718,103,40,861
2020-06-06,中国客运码头,入境,0,0,0,0
2020-06-06,中国客运码头,出境,0,0,0,0
2020-06-06,港口管制,入境,0,0,0,0
2020-06-06,港口管制,出境,0,0,0,0
2020-06-06,启德邮轮码头,入境,0,0,0,0
2020-06-06,启德邮轮码头,出境,0,0,0,0
2020-06-06,港澳客轮码头,入境,0,0,0,0
2020-06-06,港澳客轮码头,出境,0,0,0,0
2020-06-06,屯门客运码头,入境,0,0,0,0
2020-06-06,屯门客运码头,出境,0,0,0,0
2020-06-07,机场,入境,1083,3,44,1130
2020-06-07,机场,出境,520,9,120,649
2020-06-07,高铁西九龙,入境,0,0,0,0
2020-06-07,高铁西九龙,出境,0,0,0,0
2020-06-07,红磡,入境,0,0,0,0
2020-06-07,红磡,出境,0,0,0,0
2020-06-07,罗湖,入境,0,0,0,0
2020-06-07,罗湖,出境,0,0,0,0
2020-06-07,落马洲支线,入境,0,0,0,0
2020-06-07,落马洲支线,出境,0,0,0,0
2020-06-07,港珠澳大桥,入境,122,7,11,140
2020-06-07,港珠澳大桥,出境,56,3,4,63
2020-06-07,落马洲,入境,0,0,0,0
2020-06-07,落马洲,出境,0,0,0,0
2020-06-07,文锦渡,入境,0,0,0,0
2020-06-07,文锦渡,出境,0,0,0,0
2020-06-07,沙头角,入境,0,0,0,0
2020-06-07,沙头角,出境,0,0,0,0
2020-06-07,深圳湾,入境,2123,366,16,2505
2020-06-07,深圳湾,出境,670,133,3,806
2020-06-07,中国客运码头,入境,0,0,0,0
2020-06-07,中国客运码头,出境,0,0,0,0
2020-06-07,港口管制,入境,0,0,0,0
2020-06-07,港口管制,出境,0,0,0,0
2020-06-07,启德邮轮码头,入境,0,0,0,0
2020-06-07,启德邮轮码头,出境,0,0,0,0
2020-06-07,港澳客轮码头,入境,0,0,0,0
2020-06-07,港澳客轮码头,出境,0,0,0,0
2020-06-07,屯门客运码头,入境,0,0,0,0
2020-06-07,屯门客运码头,出境,0,0,0,0
2020-06-08,机场,入境,786,14,102,902
2020-06-08,机场,出境,235,17,44,296
2020-06-08,高铁西九龙,入境,0,0,0,0
2020-06-08,高铁西九龙,出境,0,0,0,0
2020-06-08,红磡,入境,0,0,0,0
2020-06-08,红磡,出境,0,0,0,0
2020-06-08,罗湖,入境,0,0,0,0
2020-06-08,罗湖,出境,0,0,0,0
2020-06-08,落马洲支线,入境,0,0,0,0
2020-06-08,落马洲支线,出境,0,0,0,0
2020-06-08,港珠澳大桥,入境,152,11,10,173
2020-06-08,港珠澳大桥,出境,113,11,3,127
2020-06-08,落马洲,入境,0,0,0,0
2020-06-08,落马洲,出境,0,0,0,0
2020-06-08,文锦渡,入境,0,0,0,0
2020-06-08,文锦渡,出境,0,0,0,0
2020-06-08,沙头角,入境,0,0,0,0
2020-06-08,沙头角,出境,0,0,0,0
2020-06-08,深圳湾,入境,2081,287,22,2390
2020-06-08,深圳湾,出境,942,107,13,1062
2020-06-08,中国客运码头,入境,0,0,0,0
2020-06-08,中国客运码头,出境,0,0,0,0
2020-06-08,港口管制,入境,0,0,0,0
2020-06-08,港口管制,出境,0,0,0,0
2020-06-08,启德邮轮码头,入境,0,0,0,0
2020-06-08,启德邮轮码头,出境,0,0,0,0
2020-06-08,港澳客轮码头,入境,0,0,0,0
2020-06-08,港澳客轮码头,出境,0,0,0,0
2020-06-08,屯门客运码头,入境,0,0,0,0
2020-06-08,屯门客运码头,出境,0,0,0,0
2020-06-09,机场,入境,559,12,30,601
2020-06-09,机场,出境,374,22,44,440
2020-06-09,高铁西九龙,入境,0,0,0,0
2020-06-09,高铁西九龙,出境,0,0,0,0
2020-06-09,红磡,入境,0,0,0,0
2020-06-09,红磡,出境,0,0,0,0
2020-06-09,罗湖,入境,0,0,0,0
2020-06-09,罗湖,出境,0,0,0,0
2020-06-09,落马洲支线,入境,0,0,0,0
2020-06-09,落马洲支线,出境,0,0,0,0
2020-06-09,港珠澳大桥,入境,99,6,8,113
2020-06-09,港珠澳大桥,出境,64,7,4,75
2020-06-09,落马洲,入境,0,0,0,0
2020-06-09,落马洲,出境,0,0,0,0
2020-06-09,文锦渡,入境,0,0,0,0
2020-06-09,文锦渡,出境,0,0,0,0
2020-06-09,沙头角,入境,0,0,0,0
2020-06-09,沙头角,出境,0,0,0,0
2020-06-09,深圳湾,入境,1481,237,19,1737
2020-06-09,深圳湾,出境,764,133,5,902
2020-06-09,中国客运码头,入境,0,0,0,0
2020-06-09,中国客运码头,出境,0,0,0,0
2020-06-09,港口管制,入境,0,0,0,0
2020-06-09,港口管制,出境,0,0,0,0
2020-06-09,启德邮轮码头,入境,0,0,0,0
2020-06-09,启德邮轮码头,出境,0,0,0,0
2020-06-09,港澳客轮码头,入境,0,0,0,0
2020-06-09,港澳客轮码头,出境,0,0,0,0
2020-06-09,屯门客运码头,入境,0,0,0,0
2020-06-09,屯门客运码头,出境,0,0,0,0
2020-06-10,机场,入境,570,3,15,588
2020-06-10,机场,出境,330,15,199,544
2020-06-10,高铁西九龙,入境,0,0,0,0
2020-06-10,高铁西九龙,出境,0,0,0,0
2020-06-10,红磡,入境,0,0,0,0
2020-06-10,红磡,出境,0,0,0,0
2020-06-10,罗湖,入境,0,0,0,0
2020-06-10,罗湖,出境,0,0,0,0
2020-06-10,落马洲支线,入境,0,0,0,0
2020-06-10,落马洲支线,出境,0,0,0,0
2020-06-10,港珠澳大桥,入境,114,12,13,139
2020-06-10,港珠澳大桥,出境,61,3,1,65
2020-06-10,落马洲,入境,0,0,0,0
2020-06-10,落马洲,出境,0,0,0,0
2020-06-10,文锦渡,入境,0,0,0,0
2020-06-10,文锦渡,出境,0,0,0,0
2020-06-10,沙头角,入境,0,0,0,0
2020-06-10,沙头角,出境,0,0,0,0
2020-06-10,深圳湾,入境,1520,251,18,1789
2020-06-10,深圳湾,出境,714,106,4,824
2020-06-10,中国客运码头,入境,0,0,0,0
2020-06-10,中国客运码头,出境,0,0,0,0
2020-06-10,港口管制,入境,0,0,0,0
2020-06-10,港口管制,出境,0,0,0,0
2020-06-10,启德邮轮码头,入境,0,0,0,0
2020-06-10,启德邮轮码头,出境,0,0,0,0
2020-06-10,港澳客轮码头,入境,0,0,0,0
2020-06-10,港澳客轮码头,出境,0,0,0,0
2020-06-10,屯门客运码头,入境,0,0,0,0
2020-06-10,屯门客运码头,出境,0,0,0,0
2020-06-11,机场,入境,626,4,19,649
2020-06-11,机场,出境,341,10,36,387
2020-06-11,高铁西九龙,入境,0,0,0,0
2020-06-11,高铁西九龙,出境,0,0,0,0
2020-06-11,红磡,入境,0,0,0,0
2020-06-11,红磡,出境,0,0,0,0
2020-06-11,罗湖,入境,0,0,0,0
2020-06-11,罗湖,出境,0,0,0,0
2020-06-11,落马洲支线,入境,0,0,0,0
2020-06-11,落马洲支线,出境,0,0,0,0
2020-06-11,港珠澳大桥,入境,83,7,5,95
2020-06-11,港珠澳大桥,出境,61,3,3,67
2020-06-11,落马洲,入境,0,0,0,0
2020-06-11,落马洲,出境,0,0,0,0
2020-06-11,文锦渡,入境,0,0,0,0
2020-06-11,文锦渡,出境,0,0,0,0
2020-06-11,沙头角,入境,0,0,0,0
2020-06-11,沙头角,出境,0,0,0,0
2020-06-11,深圳湾,入境,1018,175,8,1201
2020-06-11,深圳湾,出境,483,61,8,552
2020-06-11,中国客运码头,入境,0,0,0,0
2020-06-11,中国客运码头,出境,0,0,0,0
2020-06-11,港口管制,入境,0,0,0,0
2020-06-11,港口管制,出境,0,0,0,0
2020-06-11,启德邮轮码头,入境,0,0,0,0
2020-06-11,启德邮轮码头,出境,0,0,0,0
2020-06-11,港澳客轮码头,入境,0,0,0,0
2020-06-11,港澳客轮码头,出境,0,0,0,0
2020-06-11,屯门客运码头,入境,0,0,0,0
2020-06-11,屯门客运码头,出境,0,0,0,0
2020-06-12,机场,入境,1082,7,72,1161
2020-06-12,机场,出境,482,5,92,579
2020-06-12,高铁西九龙,入境,0,0,0,0
2020-06-12,高铁西九龙,出境,0,0,0,0
2020-06-12,红磡,入境,0,0,0,0
2020-06-12,红磡,出境,0,0,0,0
2020-06-12,罗湖,入境,0,0,0,0
2020-06-12,罗湖,出境,0,0,0,0
2020-06-12,落马洲支线,入境,0,0,0,0
2020-06-12,落马洲支线,出境,0,0,0,0
2020-06-12,港珠澳大桥,入境,68,9,31,108
2020-06-12,港珠澳大桥,出境,48,2,4,54
2020-06-12,落马洲,入境,0,0,0,0
2020-06-12,落马洲,出境,0,0,0,0
2020-06-12,文锦渡,入境,0,0,0,0
2020-06-12,文锦渡,出境,0,0,0,0
2020-06-12,沙头角,入境,0,0,0,0
2020-06-12,沙头角,出境,0,0,0,0
2020-06-12,深圳湾,入境,924,166,19,1109
2020-06-12,深圳湾,出境,451,63,6,520
2020-06-12,中国客运码头,入境,0,0,0,0
2020-06-12,中国客运码头,出境,0,0,0,0
2020-06-12,港口管制,入境,0,0,0,0
2020-06-12,港口管制,出境,0,0,0,0
2020-06-12,启德邮轮码头,入境,0,0,0,0
2020-06-12,启德邮轮码头,出境,0,0,0,0
2020-06-12,港澳客轮码头,入境,0,0,0,0
2020-06-12,港澳客轮码头,出境,0,0,0,0
2020-06-12,屯门客运码头,入境,0,0,0,0
2020-06-12,屯门客运码头,出境,0,0,0,0
2020-06-13,机场,入境,732,4,54,790
2020-06-13,机场,出境,331,14,62,407
2020-06-13,高铁西九龙,入境,0,0,0,0
2020-06-13,高铁西九龙,出境,0,0,0,0
2020-06-13,红磡,入境,0,0,0,0
2020-06-13,红磡,出境,0,0,0,0
2020-06-13,罗湖,入境,0,0,0,0
2020-06-13,罗湖,出境,0,0,0,0
2020-06-13,落马洲支线,入境,0,0,0,0
2020-06-13,落马洲支线,出境,0,0,0,0
2020-06-13,港珠澳大桥,入境,87,7,4,98
2020-06-13,港珠澳大桥,出境,50,3,4,57
2020-06-13,落马洲,入境,0,0,0,0
2020-06-13,落马洲,出境,0,0,0,0
2020-06-13,文锦渡,入境,0,0,0,0
2020-06-13,文锦渡,出境,0,0,0,0
2020-06-13,沙头角,入境,0,0,0,0
2020-06-13,沙头角,出境,0,0,0,0
2020-06-13,深圳湾,入境,863,225,19,1107
2020-06-13,深圳湾,出境,398,65,7,470
2020-06-13,中国客运码头,入境,0,0,0,0
2020-06-13,中国客运码头,出境,0,0,0,0
2020-06-13,港口管制,入境,0,0,0,0
2020-06-13,港口管制,出境,0,0,0,0
2020-06-13,启德邮轮码头,入境,0,0,0,0
2020-06-13,启德邮轮码头,出境,0,0,0,0
2020-06-13,港澳客轮码头,入境,0,0,0,0
2020-06-13,港澳客轮码头,出境,0,0,0,0
2020-06-13,屯门客运码头,入境,0,0,0,0
2020-06-13,屯门客运码头,出境,0,0,0,0
2020-06-14,机场,入境,970,3,50,1023
2020-06-14,机场,出境,550,16,80,646
2020-06-14,高铁西九龙,入境,0,0,0,0
2020-06-14,高铁西九龙,出境,0,0,0,0
2020-06-14,红磡,入境,0,0,0,0
2020-06-14,红磡,出境,0,0,0,0
2020-06-14,罗湖,入境,0,0,0,0
2020-06-14,罗湖,出境,0,0,0,0
2020-06-14,落马洲支线,入境,0,0,0,0
2020-06-14,落马洲支线,出境,0,0,0,0
2020-06-14,港珠澳大桥,入境,30,4,3,37
2020-06-14,港珠澳大桥,出境,28,3,6,37
2020-06-14,落马洲,入境,0,0,0,0
2020-06-14,落马洲,出境,0,0,0,0
2020-06-14,文锦渡,入境,0,0,0,0
2020-06-14,文锦渡,出境,0,0,0,0
2020-06-14,沙头角,入境,0,0,0,0
2020-06-14,沙头角,出境,0,0,0,0
2020-06-14,深圳湾,入境,651,149,14,814
2020-06-14,深圳湾,出境,298,79,6,383
2020-06-14,中国客运码头,入境,0,0,0,0
2020-06-14,中国客运码头,出境,0,0,0,0
2020-06-14,港口管制,入境,0,0,0,0
2020-06-14,港口管制,出境,0,0,0,0
2020-06-14,启德邮轮码头,入境,0,0,0,0
2020-06-14,启德邮轮码头,出境,0,0,0,0
2020-06-14,港澳客轮码头,入境,0,0,0,0
2020-06-14,港澳客轮码头,出境,0,0,0,0
2020-06-14,屯门客运码头,入境,0,0,0,0
2020-06-14,屯门客运码头,出境,0,0,0,0
2020-06-15,机场,入境,877,7,75,959
2020-06-15,机场,出境,280,12,58,350
2020-06-15,高铁西九龙,入境,0,0,0,0
2020-06-15,高铁西九龙,出境,0,0,0,0
2020-06-15,红磡,入境,0,0,0,0
2020-06-15,红磡,出境,0,0,0,0
2020-06-15,罗湖,入境,0,0,0,0
2020-06-15,罗湖,出境,0,0,0,0
2020-06-15,落马洲支线,入境,1297,0,0,1297
2020-06-15,落马洲支线,出境,1297,0,0,1297
2020-06-15,港珠澳大桥,入境,51,3,3,57
2020-06-15,港珠澳大桥,出境,63,1,5,69
2020-06-15,落马洲,入境,0,0,0,0
2020-06-15,落马洲,出境,0,0,0,0
2020-06-15,文锦渡,入境,0,0,0,0
2020-06-15,文锦渡,出境,0,0,0,0
2020-06-15,沙头角,入境,0,0,0,0
2020-06-15,沙头角,出境,0,0,0,0
2020-06-15,深圳湾,入境,1259,160,18,1437
2020-06-15,深圳湾,出境,858,74,23,955
2020-06-15,中国客运码头,入境,0,0,0,0
2020-06-15,中国客运码头,出境,0,0,0,0
2020-06-15,港口管制,入境,0,0,0,0
2020-06-15,港口管制,出境,0,0,0,0
2020-06-15,启德邮轮码头,入境,0,0,0,0
2020-06-15,启德邮轮码头,出境,0,0,0,0
2020-06-15,港澳客轮码头,入境,0,0,0,0
2020-06-15,港澳客轮码头,出境,0,0,0,0
2020-06-15,屯门客运码头,入境,0,0,0,0
2020-06-15,屯门客运码头,出境,0,0,0,0
2020-06-16,机场,入境,928,4,42,974
2020-06-16,机场,出境,477,19,51,547
2020-06-16,高铁西九龙,入境,0,0,0,0
2020-06-16,高铁西九龙,出境,0,0,0,0
2020-06-16,红磡,入境,0,0,0,0
2020-06-16,红磡,出境,0,0,0,0
2020-06-16,罗湖,入境,0,0,0,0
2020-06-16,罗湖,出境,0,0,0,0
2020-06-16,落马洲支线,入境,1249,0,0,1249
2020-06-16,落马洲支线,出境,1249,0,0,1249
2020-06-16,港珠澳大桥,入境,55,1,9,65
2020-06-16,港珠澳大桥,出境,82,4,11,97
2020-06-16,落马洲,入境,0,0,0,0
2020-06-16,落马洲,出境,0,0,0,0
2020-06-16,文锦渡,入境,0,0,0,0
2020-06-16,文锦渡,出境,0,0,0,0
2020-06-16,沙头角,入境,0,0,0,0
2020-06-16,沙头角,出境,0,0,0,0
2020-06-16,深圳湾,入境,1127,159,15,1301
2020-06-16,深圳湾,出境,796,77,3,876
2020-06-16,中国客运码头,入境,0,0,0,0
2020-06-16,中国客运码头,出境,0,0,0,0
2020-06-16,港口管制,入境,0,0,0,0
2020-06-16,港口管制,出境,0,0,0,0
2020-06-16,启德邮轮码头,入境,0,0,0,0
2020-06-16,启德邮轮码头,出境,0,0,0,0
2020-06-16,港澳客轮码头,入境,0,0,0,0
2020-06-16,港澳客轮码头,出境,0,0,0,0
2020-06-16,屯门客运码头,入境,0,0,0,0
2020-06-16,屯门客运码头,出境,0,0,0,0
2020-06-17,机场,入境,846,11,40,897
2020-06-17,机场,出境,243,8,35,286
2020-06-17,高铁西九龙,入境,0,0,0,0
2020-06-17,高铁西九龙,出境,0,0,0,0
2020-06-17,红磡,入境,0,0,0,0
2020-06-17,红磡,出境,0,0,0,0
2020-06-17,罗湖,入境,0,0,0,0
2020-06-17,罗湖,出境,0,0,0,0
2020-06-17,落马洲支线,入境,1272,0,0,1272
2020-06-17,落马洲支线,出境,1272,0,0,1272
2020-06-17,港珠澳大桥,入境,71,0,12,83
2020-06-17,港珠澳大桥,出境,75,6,1,82
2020-06-17,落马洲,入境,0,0,0,0
2020-06-17,落马洲,出境,0,0,0,0
2020-06-17,文锦渡,入境,0,0,0,0
2020-06-17,文锦渡,出境,0,0,0,0
2020-06-17,沙头角,入境,0,0,0,0
2020-06-17,沙头角,出境,0,0,0,0
2020-06-17,深圳湾,入境,1074,137,17,1228
2020-06-17,深圳湾,出境,796,112,2,910
2020-06-17,中国客运码头,入境,0,0,0,0
2020-06-17,中国客运码头,出境,0,0,0,0
2020-06-17,港口管制,入境,0,0,0,0
2020-06-17,港口管制,出境,0,0,0,0
2020-06-17,启德邮轮码头,入境,0,0,0,0
2020-06-17,启德邮轮码头,出境,0,0,0,0
2020-06-17,港澳客轮码头,入境,0,0,0,0
2020-06-17,港澳客轮码头,出境,0,0,0,0
2020-06-17,屯门客运码头,入境,0,0,0,0
2020-06-17,屯门客运码头,出境,0,0,0,0
2020-06-18,机场,入境,708,0,34,742
2020-06-18,机场,出境,438,6,95,539
2020-06-18,高铁西九龙,入境,0,0,0,0
2020-06-18,高铁西九龙,出境,0,0,0,0
2020-06-18,红磡,入境,0,0,0,0
2020-06-18,红磡,出境,0,0,0,0
2020-06-18,罗湖,入境,0,0,0,0
2020-06-18,罗湖,出境,0,0,0,0
2020-06-18,落马洲支线,入境,1271,0,0,1271
2020-06-18,落马洲支线,出境,1271,0,0,1271
2020-06-18,港珠澳大桥,入境,56,3,4,63
2020-06-18,港珠澳大桥,出境,60,8,3,71
2020-06-18,落马洲,入境,0,0,0,0
2020-06-18,落马洲,出境,0,0,0,0
2020-06-18,文锦渡,入境,0,0,0,0
2020-06-18,文锦渡,出境,0,0,0,0
2020-06-18,沙头角,入境,0,0,0,0
2020-06-18,沙头角,出境,0,0,0,0
2020-06-18,深圳湾,入境,1026,143,19,1188
2020-06-18,深圳湾,出境,845,92,1,938
2020-06-18,中国客运码头,入境,0,0,0,0
2020-06-18,中国客运码头,出境,0,0,0,0
2020-06-18,港口管制,入境,0,0,0,0
2020-06-18,港口管制,出境,0,0,0,0
2020-06-18,启德邮轮码头,入境,0,0,0,0
2020-06-18,启德邮轮码头,出境,0,0,0,0
2020-06-18,港澳客轮码头,入境,0,0,0,0
2020-06-18,港澳客轮码头,出境,0,0,0,0
2020-06-18,屯门客运码头,入境,0,0,0,0
2020-06-18,屯门客运码头,出境,0,0,0,0
2020-06-19,机场,入境,1022,2,86,1110
2020-06-19,机场,出境,641,5,180,826
2020-06-19,高铁西九龙,入境,0,0,0,0
2020-06-19,高铁西九龙,出境,0,0,0,0
2020-06-19,红磡,入境,0,0,0,0
2020-06-19,红磡,出境,0,0,0,0
2020-06-19,罗湖,入境,0,0,0,0
2020-06-19,罗湖,出境,0,0,0,0
2020-06-19,落马洲支线,入境,1147,0,0,1147
2020-06-19,落马洲支线,出境,1146,0,0,1146
2020-06-19,港珠澳大桥,入境,59,8,3,70
2020-06-19,港珠澳大桥,出境,71,1,8,80
2020-06-19,落马洲,入境,0,0,0,0
2020-06-19,落马洲,出境,0,0,0,0
2020-06-19,文锦渡,入境,0,0,0,0
2020-06-19,文锦渡,出境,0,0,0,0
2020-06-19,沙头角,入境,0,0,0,0
2020-06-19,沙头角,出境,0,0,0,0
2020-06-19,深圳湾,入境,1000,110,10,1120
2020-06-19,深圳湾,出境,741,75,13,829
2020-06-19,中国客运码头,入境,0,0,0,0
2020-06-19,中国客运码头,出境,0,0,0,0
2020-06-19,港口管制,入境,0,0,0,0
2020-06-19,港口管制,出境,0,0,0,0
2020-06-19,启德邮轮码头,入境,0,0,0,0
2020-06-19,启德邮轮码头,出境,0,0,0,0
2020-06-19,港澳客轮码头,入境,0,0,0,0
2020-06-19,港澳客轮码头,出境,0,0,0,0
2020-06-19,屯门客运码头,入境,0,0,0,0
2020-06-19,屯门客运码头,出境,0,0,0,0
2020-06-20,机场,入境,972,12,54,1038
2020-06-20,机场,出境,392,5,51,448
2020-06-20,高铁西九龙,入境,0,0,0,0
2020-06-20,高铁西九龙,出境,0,0,0,0
2020-06-20,红磡,入境,0,0,0,0
2020-06-20,红磡,出境,0,0,0,0
2020-06-20,罗湖,入境,0,0,0,0
2020-06-20,罗湖,出境,0,0,0,0
2020-06-20,落马洲支线,入境,0,0,0,0
2020-06-20,落马洲支线,出境,0,0,0,0
2020-06-20,港珠澳大桥,入境,46,5,8,59
2020-06-20,港珠澳大桥,出境,54,4,6,64
2020-06-20,落马洲,入境,0,0,0,0
2020-06-20,落马洲,出境,0,0,0,0
2020-06-20,文锦渡,入境,0,0,0,0
2020-06-20,文锦渡,出境,0,0,0,0
2020-06-20,沙头角,入境,0,0,0,0
2020-06-20,沙头角,出境,0,0,0,0
2020-06-20,深圳湾,入境,728,154,21,903
2020-06-20,深圳湾,出境,444,85,5,534
2020-06-20,中国客运码头,入境,0,0,0,0
2020-06-20,中国客运码头,出境,0,0,0,0
2020-06-20,港口管制,入境,0,0,0,0
2020-06-20,港口管制,出境,0,0,0,0
2020-06-20,启德邮轮码头,入境,0,0,0,0
2020-06-20,启德邮轮码头,出境,0,0,0,0
2020-06-20,港澳客轮码头,入境,0,0,0,0
2020-06-20,港澳客轮码头,出境,0,0,0,0
2020-06-20,屯门客运码头,入境,0,0,0,0
2020-06-20,屯门客运码头,出境,0,0,0,0
2020-06-21,机场,入境,1385,5,71,1461
2020-06-21,机场,出境,742,27,78,847
2020-06-21,高铁西九龙,入境,0,0,0,0
2020-06-21,高铁西九龙,出境,0,0,0,0
2020-06-21,红磡,入境,0,0,0,0
2020-06-21,红磡,出境,0,0,0,0
2020-06-21,罗湖,入境,0,0,0,0
2020-06-21,罗湖,出境,0,0,0,0
2020-06-21,落马洲支线,入境,0,0,0,0
2020-06-21,落马洲支线,出境,0,0,0,0
2020-06-21,港珠澳大桥,入境,52,0,1,53
2020-06-21,港珠澳大桥,出境,38,3,2,43
2020-06-21,落马洲,入境,0,0,0,0
2020-06-21,落马洲,出境,0,0,0,0
2020-06-21,文锦渡,入境,0,0,0,0
2020-06-21,文锦渡,出境,0,0,0,0
2020-06-21,沙头角,入境,0,0,0,0
2020-06-21,沙头角,出境,0,0,0,0
2020-06-21,深圳湾,入境,623,141,17,781
2020-06-21,深圳湾,出境,399,77,5,481
2020-06-21,中国客运码头,入境,0,0,0,0
2020-06-21,中国客运码头,出境,0,0,0,0
2020-06-21,港口管制,入境,0,0,0,0
2020-06-21,港口管制,出境,0,0,0,0
2020-06-21,启德邮轮码头,入境,0,0,0,0
2020-06-21,启德邮轮码头,出境,0,0,0,0
2020-06-21,港澳客轮码头,入境,0,0,0,0
2020-06-21,港澳客轮码头,出境,0,0,0,0
2020-06-21,屯门客运码头,入境,0,0,0,0
2020-06-21,屯门客运码头,出境,0,0,0,0
2020-06-22,机场,入境,592,7,64,663
2020-06-22,机场,出境,211,4,36,251
2020-06-22,高铁西九龙,入境,0,0,0,0
2020-06-22,高铁西九龙,出境,0,0,0,0
2020-06-22,红磡,入境,0,0,0,0
2020-06-22,红磡,出境,0,0,0,0
2020-06-22,罗湖,入境,0,0,0,0
2020-06-22,罗湖,出境,0,0,0,0
2020-06-22,落马洲支线,入境,1285,0,0,1285
2020-06-22,落马洲支线,出境,1285,0,0,1285
2020-06-22,港珠澳大桥,入境,54,4,2,60
2020-06-22,港珠澳大桥,出境,86,5,14,105
2020-06-22,落马洲,入境,0,0,0,0
2020-06-22,落马洲,出境,0,0,0,0
2020-06-22,文锦渡,入境,0,0,0,0
2020-06-22,文锦渡,出境,0,0,0,0
2020-06-22,沙头角,入境,0,0,0,0
2020-06-22,沙头角,出境,0,0,0,0
2020-06-22,深圳湾,入境,1048,168,18,1234
2020-06-22,深圳湾,出境,998,74,31,1103
2020-06-22,中国客运码头,入境,0,0,0,0
2020-06-22,中国客运码头,出境,0,0,0,0
2020-06-22,港口管制,入境,0,0,0,0
2020-06-22,港口管制,出境,0,0,0,0
2020-06-22,启德邮轮码头,入境,0,0,0,0
2020-06-22,启德邮轮码头,出境,0,0,0,0
2020-06-22,港澳客轮码头,入境,0,0,0,0
2020-06-22,港澳客轮码头,出境,0,0,0,0
2020-06-22,屯门客运码头,入境,0,0,0,0
2020-06-22,屯门客运码头,出境,0,0,0,0
2020-06-23,机场,入境,1179,9,34,1222
2020-06-23,机场,出境,429,18,54,501
2020-06-23,高铁西九龙,入境,0,0,0,0
2020-06-23,高铁西九龙,出境,0,0,0,0
2020-06-23,红磡,入境,0,0,0,0
2020-06-23,红磡,出境,0,0,0,0
2020-06-23,罗湖,入境,0,0,0,0
2020-06-23,罗湖,出境,0,0,0,0
2020-06-23,落马洲支线,入境,1299,0,0,1299
2020-06-23,落马洲支线,出境,1299,0,0,1299
2020-06-23,港珠澳大桥,入境,48,2,3,53
2020-06-23,港珠澳大桥,出境,58,3,4,65
2020-06-23,落马洲,入境,0,0,0,0
2020-06-23,落马洲,出境,0,0,0,0
2020-06-23,文锦渡,入境,0,0,0,0
2020-06-23,文锦渡,出境,0,0,0,0
2020-06-23,沙头角,入境,0,0,0,0
2020-06-23,沙头角,出境,0,0,0,0
2020-06-23,深圳湾,入境,973,136,9,1118
2020-06-23,深圳湾,出境,778,73,6,857
2020-06-23,中国客运码头,入境,0,0,0,0
2020-06-23,中国客运码头,出境,0,0,0,0
2020-06-23,港口管制,入境,0,0,0,0
2020-06-23,港口管制,出境,0,0,0,0
2020-06-23,启德邮轮码头,入境,0,0,0,0
2020-06-23,启德邮轮码头,出境,0,0,0,0
2020-06-23,港澳客轮码头,入境,0,0,0,0
2020-06-23,港澳客轮码头,出境,0,0,0,0
2020-06-23,屯门客运码头,入境,0,0,0,0
2020-06-23,屯门客运码头,出境,0,0,0,0
2020-06-24,机场,入境,738,3,55,796
2020-06-24,机场,出境,547,6,44,597
2020-06-24,高铁西九龙,入境,0,0,0,0
2020-06-24,高铁西九龙,出境,0,0,0,0
2020-06-24,红磡,入境,0,0,0,0
2020-06-24,红磡,出境,0,0,0,0
2020-06-24,罗湖,入境,0,0,0,0
2020-06-24,罗湖,出境,0,0,0,0
2020-06-24,落马洲支线,入境,1292,0,0,1292
2020-06-24,落马洲支线,出境,1293,0,0,1293
2020-06-24,港珠澳大桥,入境,52,2,3,57
2020-06-24,港珠澳大桥,出境,67,5,4,76
2020-06-24,落马洲,入境,0,0,0,0
2020-06-24,落马洲,出境,0,0,0,0
2020-06-24,文锦渡,入境,0,0,0,0
2020-06-24,文锦渡,出境,0,0,0,0
2020-06-24,沙头角,入境,0,0,0,0
2020-06-24,沙头角,出境,0,0,0,0
2020-06-24,深圳湾,入境,1019,99,15,1133
2020-06-24,深圳湾,出境,796,72,4,872
2020-06-24,中国客运码头,入境,0,0,0,0
2020-06-24,中国客运码头,出境,0,0,0,0
2020-06-24,港口管制,入境,0,0,0,0
2020-06-24,港口管制,出境,0,0,0,0
2020-06-24,启德邮轮码头,入境,0,0,0,0
2020-06-24,启德邮轮码头,出境,0,0,0,0
2020-06-24,港澳客轮码头,入境,0,0,0,0
2020-06-24,港澳客轮码头,出境,0,0,0,0
2020-06-24,屯门客运码头,入境,0,0,0,0
2020-06-24,屯门客运码头,出境,0,0,0,0
2020-06-25,机场,入境,815,2,46,863
2020-06-25,机场,出境,716,11,68,795
2020-06-25,高铁西九龙,入境,0,0,0,0
2020-06-25,高铁西九龙,出境,0,0,0,0
2020-06-25,红磡,入境,0,0,0,0
2020-06-25,红磡,出境,0,0,0,0
2020-06-25,罗湖,入境,0,0,0,0
2020-06-25,罗湖,出境,0,0,0,0
2020-06-25,落马洲支线,入境,0,0,0,0
2020-06-25,落马洲支线,出境,0,0,0,0
2020-06-25,港珠澳大桥,入境,49,2,1,52
2020-06-25,港珠澳大桥,出境,57,3,3,63
2020-06-25,落马洲,入境,0,0,0,0
2020-06-25,落马洲,出境,0,0,0,0
2020-06-25,文锦渡,入境,0,0,0,0
2020-06-25,文锦渡,出境,0,0,0,0
2020-06-25,沙头角,入境,0,0,0,0
2020-06-25,沙头角,出境,0,0,0,0
2020-06-25,深圳湾,入境,501,93,9,603
2020-06-25,深圳湾,出境,383,56,0,439
2020-06-25,中国客运码头,入境,0,0,0,0
2020-06-25,中国客运码头,出境,0,0,0,0
2020-06-25,港口管制,入境,0,0,0,0
2020-06-25,港口管制,出境,0,0,0,0
2020-06-25,启德邮轮码头,入境,0,0,0,0
2020-06-25,启德邮轮码头,出境,0,0,0,0
2020-06-25,港澳客轮码头,入境,0,0,0,0
2020-06-25,港澳客轮码头,出境,0,0,0,0
2020-06-25,屯门客运码头,入境,0,0,0,0
2020-06-25,屯门客运码头,出境,0,0,0,0
2020-06-26,机场,入境,1077,8,57,1142
2020-06-26,机场,出境,640,13,85,738
2020-06-26,高铁西九龙,入境,0,0,0,0
2020-06-26,高铁西九龙,出境,0,0,0,0
2020-06-26,红磡,入境,0,0,0,0
2020-06-26,红磡,出境,0,0,0,0
2020-06-26,罗湖,入境,0,0,0,0
2020-06-26,罗湖,出境,0,0,0,0
2020-06-26,落马洲支线,入境,1264,0,0,1264
2020-06-26,落马洲支线,出境,1264,0,0,1264
2020-06-26,港珠澳大桥,入境,40,3,6,49
2020-06-26,港珠澳大桥,出境,58,7,2,67
2020-06-26,落马洲,入境,0,0,0,0
2020-06-26,落马洲,出境,0,0,0,0
2020-06-26,文锦渡,入境,0,0,0,0
2020-06-26,文锦渡,出境,0,0,0,0
2020-06-26,沙头角,入境,0,0,0,0
2020-06-26,沙头角,出境,0,0,0,0
2020-06-26,深圳湾,入境,813,99,17,929
2020-06-26,深圳湾,出境,732,76,2,810
2020-06-26,中国客运码头,入境,0,0,0,0
2020-06-26,中国客运码头,出境,0,0,0,0
2020-06-26,港口管制,入境,0,0,0,0
2020-06-26,港口管制,出境,0,0,0,0
2020-06-26,启德邮轮码头,入境,0,0,0,0
2020-06-26,启德邮轮码头,出境,0,0,0,0
2020-06-26,港澳客轮码头,入境,0,0,0,0
2020-06-26,港澳客轮码头,出境,0,0,0,0
2020-06-26,屯门客运码头,入境,0,0,0,0
2020-06-26,屯门客运码头,出境,0,0,0,0
2020-06-27,机场,入境,1024,1,53,1078
2020-06-27,机场,出境,625,15,138,778
2020-06-27,高铁西九龙,入境,0,0,0,0
2020-06-27,高铁西九龙,出境,0,0,0,0
2020-06-27,红磡,入境,0,0,0,0
2020-06-27,红磡,出境,0,0,0,0
2020-06-27,罗湖,入境,0,0,0,0
2020-06-27,罗湖,出境,0,0,0,0
2020-06-27,落马洲支线,入境,0,0,0,0
2020-06-27,落马洲支线,出境,0,0,0,0
2020-06-27,港珠澳大桥,入境,37,7,10,54
2020-06-27,港珠澳大桥,出境,42,2,3,47
2020-06-27,落马洲,入境,0,0,0,0
2020-06-27,落马洲,出境,0,0,0,0
2020-06-27,文锦渡,入境,0,0,0,0
2020-06-27,文锦渡,出境,0,0,0,0
2020-06-27,沙头角,入境,0,0,0,0
2020-06-27,沙头角,出境,0,0,0,0
2020-06-27,深圳湾,入境,527,73,12,612
2020-06-27,深圳湾,出境,339,69,7,415
2020-06-27,中国客运码头,入境,0,0,0,0
2020-06-27,中国客运码头,出境,0,0,0,0
2020-06-27,港口管制,入境,0,0,0,0
2020-06-27,港口管制,出境,0,0,0,0
2020-06-27,启德邮轮码头,入境,0,0,0,0
2020-06-27,启德邮轮码头,出境,0,0,0,0
2020-06-27,港澳客轮码头,入境,0,0,0,0
2020-06-27,港澳客轮码头,出境,0,0,0,0
2020-06-27,屯门客运码头,入境,0,0,0,0
2020-06-27,屯门客运码头,出境,0,0,0,0
2020-06-28,机场,入境,928,5,69,1002
2020-06-28,机场,出境,874,1,103,978
2020-06-28,高铁西九龙,入境,0,0,0,0
2020-06-28,高铁西九龙,出境,0,0,0,0
2020-06-28,红磡,入境,0,0,0,0
2020-06-28,红磡,出境,0,0,0,0
2020-06-28,罗湖,入境,0,0,0,0
2020-06-28,罗湖,出境,0,0,0,0
2020-06-28,落马洲支线,入境,0,0,0,0
2020-06-28,落马洲支线,出境,0,0,0,0
2020-06-28,港珠澳大桥,入境,31,2,2,35
2020-06-28,港珠澳大桥,出境,39,0,3,42
2020-06-28,落马洲,入境,0,0,0,0
2020-06-28,落马洲,出境,0,0,0,0
2020-06-28,文锦渡,入境,0,0,0,0
2020-06-28,文锦渡,出境,0,0,0,0
2020-06-28,沙头角,入境,0,0,0,0
2020-06-28,沙头角,出境,0,0,0,0
2020-06-28,深圳湾,入境,608,117,11,736
2020-06-28,深圳湾,出境,309,42,19,370
2020-06-28,中国客运码头,入境,0,0,0,0
2020-06-28,中国客运码头,出境,0,0,0,0
2020-06-28,港口管制,入境,0,0,0,0
2020-06-28,港口管制,出境,0,0,0,0
2020-06-28,启德邮轮码头,入境,0,0,0,0
2020-06-28,启德邮轮码头,出境,0,0,0,0
2020-06-28,港澳客轮码头,入境,0,0,0,0
2020-06-28,港澳客轮码头,出境,0,0,0,0
2020-06-28,屯门客运码头,入境,0,0,0,0
2020-06-28,屯门客运码头,出境,0,0,0,0
2020-06-29,机场,入境,554,5,34,593
2020-06-29,机场,出境,336,4,108,448
2020-06-29,高铁西九龙,入境,0,0,0,0
2020-06-29,高铁西九龙,出境,0,0,0,0
2020-06-29,红磡,入境,0,0,0,0
2020-06-29,红磡,出境,0,0,0,0
2020-06-29,罗湖,入境,0,0,0,0
2020-06-29,罗湖,出境,0,0,0,0
2020-06-29,落马洲支线,入境,1300,0,0,1300
2020-06-29,落马洲支线,出境,1300,0,0,1300
2020-06-29,港珠澳大桥,入境,40,3,4,47
2020-06-29,港珠澳大桥,出境,76,4,3,83
2020-06-29,落马洲,入境,0,0,0,0
2020-06-29,落马洲,出境,0,0,0,0
2020-06-29,文锦渡,入境,0,0,0,0
2020-06-29,文锦渡,出境,0,0,0,0
2020-06-29,沙头角,入境,0,0,0,0
2020-06-29,沙头角,出境,0,0,0,0
2020-06-29,深圳湾,入境,865,80,6,951
2020-06-29,深圳湾,出境,774,52,20,846
2020-06-29,中国客运码头,入境,0,0,0,0
2020-06-29,中国客运码头,出境,0,0,0,0
2020-06-29,港口管制,入境,0,0,0,0
2020-06-29,港口管制,出境,0,0,0,0
2020-06-29,启德邮轮码头,入境,0,0,0,0
2020-06-29,启德邮轮码头,出境,0,0,0,0
2020-06-29,港澳客轮码头,入境,0,0,0,0
2020-06-29,港澳客轮码头,出境,0,0,0,0
2020-06-29,屯门客运码头,入境,0,0,0,0
2020-06-29,屯门客运码头,出境,0,0,0,0
2020-06-30,机场,入境,1221,7,82,1310
2020-06-30,机场,出境,730,5,62,797
2020-06-30,高铁西九龙,入境,0,0,0,0
2020-06-30,高铁西九龙,出境,0,0,0,0
2020-06-30,红磡,入境,0,0,0,0
2020-06-30,红磡,出境,0,0,0,0
2020-06-30,罗湖,入境,0,0,0,0
2020-06-30,罗湖,出境,0,0,0,0
2020-06-30,落马洲支线,入境,1235,0,0,1235
2020-06-30,落马洲支线,出境,1235,0,0,1235
2020-06-30,港珠澳大桥,入境,42,3,3,48
2020-06-30,港珠澳大桥,出境,88,4,6,98
2020-06-30,落马洲,入境,0,0,0,0
2020-06-30,落马洲,出境,0,0,0,0
2020-06-30,文锦渡,入境,0,0,0,0
2020-06-30,文锦渡,出境,0,0,0,0
2020-06-30,沙头角,入境,0,0,0,0
2020-06-30,沙头角,出境,0,0,0,0
2020-06-30,深圳湾,入境,928,159,10,1097
2020-06-30,深圳湾,出境,878,85,3,966
2020-06-30,中国客运码头,入境,0,0,0,0
2020-06-30,中国客运码头,出境,0,0,0,0
2020-06-30,港口管制,入境,0,0,0,0
2020-06-30,港口管制,出境,0,0,0,0
2020-06-30,启德邮轮码头,入境,0,0,0,0
2020-06-30,启德邮轮码头,出境,0,0,0,0
2020-06-30,港澳客轮码头,入境,0,0,0,0
2020-06-30,港澳客轮码头,出境,0,0,0,0
2020-06-30,屯门客运码头,入境,0,0,0,0
2020-06-30,屯门客运码头,出境,0,0,0,0
2020-07-01,机场,入境,682,3,58,743
2020-07-01,机场,出境,1022,20,82,1124
2020-07-01,高铁西九龙,入境,0,0,0,0
2020-07-01,高铁西九龙,出境,0,0,0,0
2020-07-01,红磡,入境,0,0,0,0
2020-07-01,红磡,出境,0,0,0,0
2020-07-01,罗湖,入境,0,0,0,0
2020-07-01,罗湖,出境,0,0,0,0
2020-07-01,落马洲支线,入境,0,0,0,0
2020-07-01,落马洲支线,出境,0,0,0,0
2020-07-01,港珠澳大桥,入境,41,7,4,52
2020-07-01,港珠澳大桥,出境,75,9,5,89
2020-07-01,落马洲,入境,0,0,0,0
2020-07-01,落马洲,出境,0,0,0,0
2020-07-01,文锦渡,入境,0,0,0,0
2020-07-01,文锦渡,出境,0,0,0,0
2020-07-01,沙头角,入境,0,0,0,0
2020-07-01,沙头角,出境,0,0,0,0
2020-07-01,深圳湾,入境,566,104,8,678
2020-07-01,深圳湾,出境,496,86,3,585
2020-07-01,中国客运码头,入境,0,0,0,0
2020-07-01,中国客运码头,出境,0,0,0,0
2020-07-01,港口管制,入境,0,0,0,0
2020-07-01,港口管制,出境,0,0,0,0
2020-07-01,启德邮轮码头,入境,0,0,0,0
2020-07-01,启德邮轮码头,出境,0,0,0,0
2020-07-01,港澳客轮码头,入境,0,0,0,0
2020-07-01,港澳客轮码头,出境,0,0,0,0
2020-07-01,屯门客运码头,入境,0,0,0,0
2020-07-01,屯门客运码头,出境,0,0,0,0
2020-07-02,机场,入境,1017,5,75,1097
2020-07-02,机场,出境,880,23,60,963
2020-07-02,高铁西九龙,入境,0,0,0,0
2020-07-02,高铁西九龙,出境,0,0,0,0
2020-07-02,红磡,入境,0,0,0,0
2020-07-02,红磡,出境,0,0,0,0
2020-07-02,罗湖,入境,0,0,0,0
2020-07-02,罗湖,出境,0,0,0,0
2020-07-02,落马洲支线,入境,1291,0,0,1291
2020-07-02,落马洲支线,出境,1291,0,0,1291
2020-07-02,港珠澳大桥,入境,73,1,3,77
2020-07-02,港珠澳大桥,出境,86,9,3,98
2020-07-02,落马洲,入境,0,0,0,0
2020-07-02,落马洲,出境,0,0,0,0
2020-07-02,文锦渡,入境,0,0,0,0
2020-07-02,文锦渡,出境,0,0,0,0
2020-07-02,沙头角,入境,0,0,0,0
2020-07-02,沙头角,出境,0,0,0,0
2020-07-02,深圳湾,入境,981,86,11,1078
2020-07-02,深圳湾,出境,918,88,8,1014
2020-07-02,中国客运码头,入境,0,0,0,0
2020-07-02,中国客运码头,出境,0,0,0,0
2020-07-02,港口管制,入境,0,0,0,0
2020-07-02,港口管制,出境,0,0,0,0
2020-07-02,启德邮轮码头,入境,0,0,0,0
2020-07-02,启德邮轮码头,出境,0,0,0,0
2020-07-02,港澳客轮码头,入境,0,0,0,0
2020-07-02,港澳客轮码头,出境,0,0,0,0
2020-07-02,屯门客运码头,入境,0,0,0,0
2020-07-02,屯门客运码头,出境,0,0,0,0
2020-07-03,机场,入境,1145,7,71,1223
2020-07-03,机场,出境,1054,17,87,1158
2020-07-03,高铁西九龙,入境,0,0,0,0
2020-07-03,高铁西九龙,出境,0,0,0,0
2020-07-03,红磡,入境,0,0,0,0
2020-07-03,红磡,出境,0,0,0,0
2020-07-03,罗湖,入境,0,0,0,0
2020-07-03,罗湖,出境,0,0,0,0
2020-07-03,落马洲支线,入境,1219,0,0,1219
2020-07-03,落马洲支线,出境,1219,0,0,1219
2020-07-03,港珠澳大桥,入境,57,7,3,67
2020-07-03,港珠澳大桥,出境,84,6,7,97
2020-07-03,落马洲,入境,0,0,0,0
2020-07-03,落马洲,出境,0,0,0,0
2020-07-03,文锦渡,入境,0,0,0,0
2020-07-03,文锦渡,出境,0,0,0,0
2020-07-03,沙头角,入境,0,0,0,0
2020-07-03,沙头角,出境,0,0,0,0
2020-07-03,深圳湾,入境,1063,134,5,1202
2020-07-03,深圳湾,出境,868,107,14,989
2020-07-03,中国客运码头,入境,0,0,0,0
2020-07-03,中国客运码头,出境,0,0,0,0
2020-07-03,港口管制,入境,0,0,0,0
2020-07-03,港口管制,出境,0,0,0,0
2020-07-03,启德邮轮码头,入境,0,0,0,0
2020-07-03,启德邮轮码头,出境,0,0,0,0
2020-07-03,港澳客轮码头,入境,0,0,0,0
2020-07-03,港澳客轮码头,出境,0,0,0,0
2020-07-03,屯门客运码头,入境,0,0,0,0
2020-07-03,屯门客运码头,出境,0,0,0,0
2020-07-04,机场,入境,1068,13,57,1138
2020-07-04,机场,出境,809,9,133,951
2020-07-04,高铁西九龙,入境,0,0,0,0
2020-07-04,高铁西九龙,出境,0,0,0,0
2020-07-04,红磡,入境,0,0,0,0
2020-07-04,红磡,出境,0,0,0,0
2020-07-04,罗湖,入境,0,0,0,0
2020-07-04,罗湖,出境,0,0,0,0
2020-07-04,落马洲支线,入境,0,0,0,0
2020-07-04,落马洲支线,出境,0,0,0,0
2020-07-04,港珠澳大桥,入境,66,8,3,77
2020-07-04,港珠澳大桥,出境,79,3,5,87
2020-07-04,落马洲,入境,0,0,0,0
2020-07-04,落马洲,出境,0,0,0,0
2020-07-04,文锦渡,入境,0,0,0,0
2020-07-04,文锦渡,出境,0,0,0,0
2020-07-04,沙头角,入境,0,0,0,0
2020-07-04,沙头角,出境,0,0,0,0
2020-07-04,深圳湾,入境,746,145,11,902
2020-07-04,深圳湾,出境,707,109,14,830
2020-07-04,中国客运码头,入境,0,0,0,0
2020-07-04,中国客运码头,出境,0,0,0,0
2020-07-04,港口管制,入境,0,0,0,0
2020-07-04,港口管制,出境,0,0,0,0
2020-07-04,启德邮轮码头,入境,0,0,0,0
2020-07-04,启德邮轮码头,出境,0,0,0,0
2020-07-04,港澳客轮码头,入境,0,0,0,0
2020-07-04,港澳客轮码头,出境,0,0,0,0
2020-07-04,屯门客运码头,入境,0,0,0,0
2020-07-04,屯门客运码头,出境,0,0,0,0
2020-07-05,机场,入境,1276,6,48,1330
2020-07-05,机场,出境,994,14,151,1159
2020-07-05,高铁西九龙,入境,0,0,0,0
2020-07-05,高铁西九龙,出境,0,0,0,0
2020-07-05,红磡,入境,0,0,0,0
2020-07-05,红磡,出境,0,0,0,0
2020-07-05,罗湖,入境,0,0,0,0
2020-07-05,罗湖,出境,0,0,0,0
2020-07-05,落马洲支线,入境,0,0,0,0
2020-07-05,落马洲支线,出境,0,0,0,0
2020-07-05,港珠澳大桥,入境,70,6,4,80
2020-07-05,港珠澳大桥,出境,89,12,2,103
2020-07-05,落马洲,入境,0,0,0,0
2020-07-05,落马洲,出境,0,0,0,0
2020-07-05,文锦渡,入境,0,0,0,0
2020-07-05,文锦渡,出境,0,0,0,0
2020-07-05,沙头角,入境,0,0,0,0
2020-07-05,沙头角,出境,0,0,0,0
2020-07-05,深圳湾,入境,942,197,13,1152
2020-07-05,深圳湾,出境,664,131,4,799
2020-07-05,中国客运码头,入境,0,0,0,0
2020-07-05,中国客运码头,出境,0,0,0,0
2020-07-05,港口管制,入境,0,0,0,0
2020-07-05,港口管制,出境,0,0,0,0
2020-07-05,启德邮轮码头,入境,0,0,0,0
2020-07-05,启德邮轮码头,出境,0,0,0,0
2020-07-05,港澳客轮码头,入境,0,0,0,0
2020-07-05,港澳客轮码头,出境,0,0,0,0
2020-07-05,屯门客运码头,入境,0,0,0,0
2020-07-05,屯门客运码头,出境,0,0,0,0
2020-07-06,机场,入境,843,4,46,893
2020-07-06,机场,出境,312,2,110,424
2020-07-06,高铁西九龙,入境,0,0,0,0
2020-07-06,高铁西九龙,出境,0,0,0,0
2020-07-06,红磡,入境,0,0,0,0
2020-07-06,红磡,出境,0,0,0,0
2020-07-06,罗湖,入境,0,0,0,0
2020-07-06,罗湖,出境,0,0,0,0
2020-07-06,落马洲支线,入境,1133,0,0,1133
2020-07-06,落马洲支线,出境,1133,0,0,1133
2020-07-06,港珠澳大桥,入境,106,2,3,111
2020-07-06,港珠澳大桥,出境,113,6,4,123
2020-07-06,落马洲,入境,0,0,0,0
2020-07-06,落马洲,出境,0,0,0,0
2020-07-06,文锦渡,入境,0,0,0,0
2020-07-06,文锦渡,出境,0,0,0,0
2020-07-06,沙头角,入境,0,0,0,0
2020-07-06,沙头角,出境,0,0,0,0
2020-07-06,深圳湾,入境,1318,137,16,1471
2020-07-06,深圳湾,出境,1040,117,16,1173
2020-07-06,中国客运码头,入境,0,0,0,0
2020-07-06,中国客运码头,出境,0,0,0,0
2020-07-06,港口管制,入境,0,0,0,0
2020-07-06,港口管制,出境,0,0,0,0
2020-07-06,启德邮轮码头,入境,0,0,0,0
2020-07-06,启德邮轮码头,出境,0,0,0,0
2020-07-06,港澳客轮码头,入境,0,0,0,0
2020-07-06,港澳客轮码头,出境,0,0,0,0
2020-07-06,屯门客运码头,入境,0,0,0,0
2020-07-06,屯门客运码头,出境,0,0,0,0
2020-07-07,机场,入境,1044,8,36,1088
2020-07-07,机场,出境,819,18,81,918
2020-07-07,高铁西九龙,入境,0,0,0,0
2020-07-07,高铁西九龙,出境,0,0,0,0
2020-07-07,红磡,入境,0,0,0,0
2020-07-07,红磡,出境,0,0,0,0
2020-07-07,罗湖,入境,0,0,0,0
2020-07-07,罗湖,出境,0,0,0,0
2020-07-07,落马洲支线,入境,1186,0,0,1186
2020-07-07,落马洲支线,出境,1186,0,0,1186
2020-07-07,港珠澳大桥,入境,104,4,9,117
2020-07-07,港珠澳大桥,出境,138,5,8,151
2020-07-07,落马洲,入境,0,0,0,0
2020-07-07,落马洲,出境,0,0,0,0
2020-07-07,文锦渡,入境,0,0,0,0
2020-07-07,文锦渡,出境,0,0,0,0
2020-07-07,沙头角,入境,0,0,0,0
2020-07-07,沙头角,出境,0,0,0,0
2020-07-07,深圳湾,入境,1279,155,14,1448
2020-07-07,深圳湾,出境,1106,130,6,1242
2020-07-07,中国客运码头,入境,0,0,0,0
2020-07-07,中国客运码头,出境,0,0,0,0
2020-07-07,港口管制,入境,0,0,0,0
2020-07-07,港口管制,出境,0,0,0,0
2020-07-07,启德邮轮码头,入境,0,0,0,0
2020-07-07,启德邮轮码头,出境,0,0,0,0
2020-07-07,港澳客轮码头,入境,0,0,0,0
2020-07-07,港澳客轮码头,出境,0,0,0,0
2020-07-07,屯门客运码头,入境,0,0,0,0
2020-07-07,屯门客运码头,出境,0,0,0,0
2020-07-08,机场,入境,1091,11,76,1178
2020-07-08,机场,出境,774,5,197,976
2020-07-08,高铁西九龙,入境,0,0,0,0
2020-07-08,高铁西九龙,出境,0,0,0,0
2020-07-08,红磡,入境,0,0,0,0
2020-07-08,红磡,出境,0,0,0,0
2020-07-08,罗湖,入境,0,0,0,0
2020-07-08,罗湖,出境,0,0,0,0
2020-07-08,落马洲支线,入境,1030,0,0,1030
2020-07-08,落马洲支线,出境,1030,0,0,1030
2020-07-08,港珠澳大桥,入境,122,6,6,134
2020-07-08,港珠澳大桥,出境,172,7,8,187
2020-07-08,落马洲,入境,0,0,0,0
2020-07-08,落马洲,出境,0,0,0,0
2020-07-08,文锦渡,入境,0,0,0,0
2020-07-08,文锦渡,出境,0,0,0,0
2020-07-08,沙头角,入境,0,0,0,0
2020-07-08,沙头角,出境,0,0,0,0
2020-07-08,深圳湾,入境,1428,184,20,1632
2020-07-08,深圳湾,出境,1341,175,5,1521
2020-07-08,中国客运码头,入境,0,0,0,0
2020-07-08,中国客运码头,出境,0,0,0,0
2020-07-08,港口管制,入境,0,0,0,0
2020-07-08,港口管制,出境,0,0,0,0
2020-07-08,启德邮轮码头,入境,0,0,0,0
2020-07-08,启德邮轮码头,出境,0,0,0,0
2020-07-08,港澳客轮码头,入境,0,0,0,0
2020-07-08,港澳客轮码头,出境,0,0,0,0
2020-07-08,屯门客运码头,入境,0,0,0,0
2020-07-08,屯门客运码头,出境,0,0,0,0
2020-07-09,机场,入境,661,9,44,714
2020-07-09,机场,出境,727,21,84,832
2020-07-09,高铁西九龙,入境,0,0,0,0
2020-07-09,高铁西九龙,出境,0,0,0,0
2020-07-09,红磡,入境,0,0,0,0
2020-07-09,红磡,出境,0,0,0,0
2020-07-09,罗湖,入境,0,0,0,0
2020-07-09,罗湖,出境,0,0,0,0
2020-07-09,落马洲支线,入境,721,0,0,721
2020-07-09,落马洲支线,出境,721,0,0,721
2020-07-09,港珠澳大桥,入境,98,5,3,106
2020-07-09,港珠澳大桥,出境,212,10,8,230
2020-07-09,落马洲,入境,0,0,0,0
2020-07-09,落马洲,出境,0,0,0,0
2020-07-09,文锦渡,入境,0,0,0,0
2020-07-09,文锦渡,出境,0,0,0,0
2020-07-09,沙头角,入境,0,0,0,0
2020-07-09,沙头角,出境,0,0,0,0
2020-07-09,深圳湾,入境,1336,161,7,1504
2020-07-09,深圳湾,出境,1178,195,9,1382
2020-07-09,中国客运码头,入境,0,0,0,0
2020-07-09,中国客运码头,出境,0,0,0,0
2020-07-09,港口管制,入境,0,0,0,0
2020-07-09,港口管制,出境,0,0,0,0
2020-07-09,启德邮轮码头,入境,0,0,0,0
2020-07-09,启德邮轮码头,出境,0,0,0,0
2020-07-09,港澳客轮码头,入境,0,0,0,0
2020-07-09,港澳客轮码头,出境,0,0,0,0
2020-07-09,屯门客运码头,入境,0,0,0,0
2020-07-09,屯门客运码头,出境,0,0,0,0
2020-07-10,机场,入境,1298,2,105,1405
2020-07-10,机场,出境,852,29,96,977
2020-07-10,高铁西九龙,入境,0,0,0,0
2020-07-10,高铁西九龙,出境,0,0,0,0
2020-07-10,红磡,入境,0,0,0,0
2020-07-10,红磡,出境,0,0,0,0
2020-07-10,罗湖,入境,0,0,0,0
2020-07-10,罗湖,出境,0,0,0,0
2020-07-10,落马洲支线,入境,827,0,0,827
2020-07-10,落马洲支线,出境,827,0,0,827
2020-07-10,港珠澳大桥,入境,102,11,5,118
2020-07-10,港珠澳大桥,出境,239,23,16,278
2020-07-10,落马洲,入境,0,0,0,0
2020-07-10,落马洲,出境,0,0,0,0
2020-07-10,文锦渡,入境,0,0,0,0
2020-07-10,文锦渡,出境,0,0,0,0
2020-07-10,沙头角,入境,0,0,0,0
2020-07-10,沙头角,出境,0,0,0,0
2020-07-10,深圳湾,入境,1102,162,10,1274
2020-07-10,深圳湾,出境,1567,229,16,1812
2020-07-10,中国客运码头,入境,0,0,0,0
2020-07-10,中国客运码头,出境,0,0,0,0
2020-07-10,港口管制,入境,0,0,0,0
2020-07-10,港口管制,出境,0,0,0,0
2020-07-10,启德邮轮码头,入境,0,0,0,0
2020-07-10,启德邮轮码头,出境,0,0,0,0
2020-07-10,港澳客轮码头,入境,0,0,0,0
2020-07-10,港澳客轮码头,出境,0,0,0,0
2020-07-10,屯门客运码头,入境,0,0,0,0
2020-07-10,屯门客运码头,出境,0,0,0,0
2020-07-11,机场,入境,1248,13,75,1336
2020-07-11,机场,出境,791,19,92,902
2020-07-11,高铁西九龙,入境,0,0,0,0
2020-07-11,高铁西九龙,出境,0,0,0,0
2020-07-11,红磡,入境,0,0,0,0
2020-07-11,红磡,出境,0,0,0,0
2020-07-11,罗湖,入境,0,0,0,0
2020-07-11,罗湖,出境,0,0,0,0
2020-07-11,落马洲支线,入境,0,0,0,0
2020-07-11,落马洲支线,出境,0,0,0,0
2020-07-11,港珠澳大桥,入境,75,2,7,84
2020-07-11,港珠澳大桥,出境,263,41,9,313
2020-07-11,落马洲,入境,0,0,0,0
2020-07-11,落马洲,出境,0,0,0,0
2020-07-11,文锦渡,入境,0,0,0,0
2020-07-11,文锦渡,出境,0,0,0,0
2020-07-11,沙头角,入境,0,0,0,0
2020-07-11,沙头角,出境,0,0,0,0
2020-07-11,深圳湾,入境,737,159,10,906
2020-07-11,深圳湾,出境,2017,427,11,2455
2020-07-11,中国客运码头,入境,0,0,0,0
2020-07-11,中国客运码头,出境,0,0,0,0
2020-07-11,港口管制,入境,0,0,0,0
2020-07-11,港口管制,出境,0,0,0,0
2020-07-11,启德邮轮码头,入境,0,0,0,0
2020-07-11,启德邮轮码头,出境,0,0,0,0
2020-07-11,港澳客轮码头,入境,0,0,0,0
2020-07-11,港澳客轮码头,出境,0,0,0,0
2020-07-11,屯门客运码头,入境,0,0,0,0
2020-07-11,屯门客运码头,出境,0,0,0,0
2020-07-12,机场,入境,1105,10,79,1194
2020-07-12,机场,出境,1114,61,109,1284
2020-07-12,高铁西九龙,入境,0,0,0,0
2020-07-12,高铁西九龙,出境,0,0,0,0
2020-07-12,红磡,入境,0,0,0,0
2020-07-12,红磡,出境,0,0,0,0
2020-07-12,罗湖,入境,0,0,0,0
2020-07-12,罗湖,出境,0,0,0,0
2020-07-12,落马洲支线,入境,0,0,0,0
2020-07-12,落马洲支线,出境,0,0,0,0
2020-07-12,港珠澳大桥,入境,71,6,9,86
2020-07-12,港珠澳大桥,出境,259,34,5,298
2020-07-12,落马洲,入境,0,0,0,0
2020-07-12,落马洲,出境,0,0,0,0
2020-07-12,文锦渡,入境,0,0,0,0
2020-07-12,文锦渡,出境,0,0,0,0
2020-07-12,沙头角,入境,0,0,0,0
2020-07-12,沙头角,出境,0,0,0,0
2020-07-12,深圳湾,入境,826,116,7,949
2020-07-12,深圳湾,出境,1528,339,17,1884
2020-07-12,中国客运码头,入境,0,0,0,0
2020-07-12,中国客运码头,出境,0,0,0,0
2020-07-12,港口管制,入境,0,0,0,0
2020-07-12,港口管制,出境,0,0,0,0
2020-07-12,启德邮轮码头,入境,0,0,0,0
2020-07-12,启德邮轮码头,出境,0,0,0,0
2020-07-12,港澳客轮码头,入境,0,0,0,0
2020-07-12,港澳客轮码头,出境,0,0,0,0
2020-07-12,屯门客运码头,入境,0,0,0,0
2020-07-12,屯门客运码头,出境,0,0,0,0
2020-07-13,机场,入境,731,9,55,795
2020-07-13,机场,出境,326,30,62,418
2020-07-13,高铁西九龙,入境,0,0,0,0
2020-07-13,高铁西九龙,出境,0,0,0,0
2020-07-13,红磡,入境,0,0,0,0
2020-07-13,红磡,出境,0,0,0,0
2020-07-13,罗湖,入境,0,0,0,0
2020-07-13,罗湖,出境,0,0,0,0
2020-07-13,落马洲支线,入境,151,0,0,151
2020-07-13,落马洲支线,出境,151,0,0,151
2020-07-13,港珠澳大桥,入境,99,2,3,104
2020-07-13,港珠澳大桥,出境,393,43,4,440
2020-07-13,落马洲,入境,0,0,0,0
2020-07-13,落马洲,出境,0,0,0,0
2020-07-13,文锦渡,入境,0,0,0,0
2020-07-13,文锦渡,出境,0,0,0,0
2020-07-13,沙头角,入境,0,0,0,0
2020-07-13,沙头角,出境,0,0,0,0
2020-07-13,深圳湾,入境,935,109,11,1055
2020-07-13,深圳湾,出境,2326,355,21,2702
2020-07-13,中国客运码头,入境,0,0,0,0
2020-07-13,中国客运码头,出境,0,0,0,0
2020-07-13,港口管制,入境,0,0,0,0
2020-07-13,港口管制,出境,0,0,0,0
2020-07-13,启德邮轮码头,入境,0,0,0,0
2020-07-13,启德邮轮码头,出境,0,0,0,0
2020-07-13,港澳客轮码头,入境,0,0,0,0
2020-07-13,港澳客轮码头,出境,0,0,0,0
2020-07-13,屯门客运码头,入境,0,0,0,0
2020-07-13,屯门客运码头,出境,0,0,0,0
2020-07-14,机场,入境,768,8,55,831
2020-07-14,机场,出境,1082,66,84,1232
2020-07-14,高铁西九龙,入境,0,0,0,0
2020-07-14,高铁西九龙,出境,0,0,0,0
2020-07-14,红磡,入境,0,0,0,0
2020-07-14,红磡,出境,0,0,0,0
2020-07-14,罗湖,入境,0,0,0,0
2020-07-14,罗湖,出境,0,0,0,0
2020-07-14,落马洲支线,入境,57,0,0,57
2020-07-14,落马洲支线,出境,57,0,0,57
2020-07-14,港珠澳大桥,入境,47,2,1,50
2020-07-14,港珠澳大桥,出境,516,65,5,586
2020-07-14,落马洲,入境,0,0,0,0
2020-07-14,落马洲,出境,0,0,0,0
2020-07-14,文锦渡,入境,0,0,0,0
2020-07-14,文锦渡,出境,0,0,0,0
2020-07-14,沙头角,入境,0,0,0,0
2020-07-14,沙头角,出境,0,0,0,0
2020-07-14,深圳湾,入境,715,88,7,810
2020-07-14,深圳湾,出境,2694,469,19,3182
2020-07-14,中国客运码头,入境,0,0,0,0
2020-07-14,中国客运码头,出境,0,0,0,0
2020-07-14,港口管制,入境,0,0,0,0
2020-07-14,港口管制,出境,0,0,0,0
2020-07-14,启德邮轮码头,入境,0,0,0,0
2020-07-14,启德邮轮码头,出境,0,0,0,0
2020-07-14,港澳客轮码头,入境,0,0,0,0
2020-07-14,港澳客轮码头,出境,0,0,0,0
2020-07-14,屯门客运码头,入境,0,0,0,0
2020-07-14,屯门客运码头,出境,0,0,0,0
2020-07-15,机场,入境,1035,3,58,1096
2020-07-15,机场,出境,880,20,74,974
2020-07-15,高铁西九龙,入境,0,0,0,0
2020-07-15,高铁西九龙,出境,0,0,0,0
2020-07-15,红磡,入境,0,0,0,0
2020-07-15,红磡,出境,0,0,0,0
2020-07-15,罗湖,入境,0,0,0,0
2020-07-15,罗湖,出境,0,0,0,0
2020-07-15,落马洲支线,入境,65,0,0,65
2020-07-15,落马洲支线,出境,65,0,0,65
2020-07-15,港珠澳大桥,入境,98,3,3,104
2020-07-15,港珠澳大桥,出境,637,87,8,732
2020-07-15,落马洲,入境,0,0,0,0
2020-07-15,落马洲,出境,0,0,0,0
2020-07-15,文锦渡,入境,0,0,0,0
2020-07-15,文锦渡,出境,0,0,0,0
2020-07-15,沙头角,入境,0,0,0,0
2020-07-15,沙头角,出境,0,0,0,0
2020-07-15,深圳湾,入境,752,83,7,842
2020-07-15,深圳湾,出境,2660,470,16,3146
2020-07-15,中国客运码头,入境,0,0,0,0
2020-07-15,中国客运码头,出境,0,0,0,0
2020-07-15,港口管制,入境,0,0,0,0
2020-07-15,港口管制,出境,0,0,0,0
2020-07-15,启德邮轮码头,入境,0,0,0,0
2020-07-15,启德邮轮码头,出境,0,0,0,0
2020-07-15,港澳客轮码头,入境,0,0,0,0
2020-07-15,港澳客轮码头,出境,0,0,0,0
2020-07-15,屯门客运码头,入境,0,0,0,0
2020-07-15,屯门客运码头,出境,0,0,0,0
2020-07-16,机场,入境,516,3,28,547
2020-07-16,机场,出境,706,24,36,766
2020-07-16,高铁西九龙,入境,0,0,0,0
2020-07-16,高铁西九龙,出境,0,0,0,0
2020-07-16,红磡,入境,0,0,0,0
2020-07-16,红磡,出境,0,0,0,0
2020-07-16,罗湖,入境,0,0,0,0
2020-07-16,罗湖,出境,0,0,0,0
2020-07-16,落马洲支线,入境,58,0,0,58
2020-07-16,落马洲支线,出境,58,0,0,58
2020-07-16,港珠澳大桥,入境,91,5,8,104
2020-07-16,港珠澳大桥,出境,538,66,8,612
2020-07-16,落马洲,入境,0,0,0,0
2020-07-16,落马洲,出境,0,0,0,0
2020-07-16,文锦渡,入境,0,0,0,0
2020-07-16,文锦渡,出境,0,0,0,0
2020-07-16,沙头角,入境,0,0,0,0
2020-07-16,沙头角,出境,0,0,0,0
2020-07-16,深圳湾,入境,651,85,8,744
2020-07-16,深圳湾,出境,2576,346,16,2938
2020-07-16,中国客运码头,入境,0,0,0,0
2020-07-16,中国客运码头,出境,0,0,0,0
2020-07-16,港口管制,入境,0,0,0,0
2020-07-16,港口管制,出境,0,0,0,0
2020-07-16,启德邮轮码头,入境,0,0,0,0
2020-07-16,启德邮轮码头,出境,0,0,0,0
2020-07-16,港澳客轮码头,入境,0,0,0,0
2020-07-16,港澳客轮码头,出境,0,0,0,0
2020-07-16,屯门客运码头,入境,0,0,0,0
2020-07-16,屯门客运码头,出境,0,0,0,0
2020-07-17,机场,入境,1073,7,82,1162
2020-07-17,机场,出境,1209,51,72,1332
2020-07-17,高铁西九龙,入境,0,0,0,0
2020-07-17,高铁西九龙,出境,0,0,0,0
2020-07-17,红磡,入境,0,0,0,0
2020-07-17,红磡,出境,0,0,0,0
2020-07-17,罗湖,入境,0,0,0,0
2020-07-17,罗湖,出境,0,0,0,0
2020-07-17,落马洲支线,入境,37,0,0,37
2020-07-17,落马洲支线,出境,37,0,0,37
2020-07-17,港珠澳大桥,入境,69,2,3,74
2020-07-17,港珠澳大桥,出境,94,1,3,98
2020-07-17,落马洲,入境,0,0,0,0
2020-07-17,落马洲,出境,0,0,0,0
2020-07-17,文锦渡,入境,0,0,0,0
2020-07-17,文锦渡,出境,0,0,0,0
2020-07-17,沙头角,入境,0,0,0,0
2020-07-17,沙头角,出境,0,0,0,0
2020-07-17,深圳湾,入境,588,54,16,658
2020-07-17,深圳湾,出境,360,45,11,416
2020-07-17,中国客运码头,入境,0,0,0,0
2020-07-17,中国客运码头,出境,0,0,0,0
2020-07-17,港口管制,入境,0,0,0,0
2020-07-17,港口管制,出境,0,0,0,0
2020-07-17,启德邮轮码头,入境,0,0,0,0
2020-07-17,启德邮轮码头,出境,0,0,0,0
2020-07-17,港澳客轮码头,入境,0,0,0,0
2020-07-17,港澳客轮码头,出境,0,0,0,0
2020-07-17,屯门客运码头,入境,0,0,0,0
2020-07-17,屯门客运码头,出境,0,0,0,0
2020-07-18,机场,入境,693,12,45,750
2020-07-18,机场,出境,1074,65,69,1208
2020-07-18,高铁西九龙,入境,0,0,0,0
2020-07-18,高铁西九龙,出境,0,0,0,0
2020-07-18,红磡,入境,0,0,0,0
2020-07-18,红磡,出境,0,0,0,0
2020-07-18,罗湖,入境,0,0,0,0
2020-07-18,罗湖,出境,0,0,0,0
2020-07-18,落马洲支线,入境,0,0,0,0
2020-07-18,落马洲支线,出境,0,0,0,0
2020-07-18,港珠澳大桥,入境,58,3,5,66
2020-07-18,港珠澳大桥,出境,153,16,7,176
2020-07-18,落马洲,入境,0,0,0,0
2020-07-18,落马洲,出境,0,0,0,0
2020-07-18,文锦渡,入境,0,0,0,0
2020-07-18,文锦渡,出境,0,0,0,0
2020-07-18,沙头角,入境,0,0,0,0
2020-07-18,沙头角,出境,0,0,0,0
2020-07-18,深圳湾,入境,472,75,4,551
2020-07-18,深圳湾,出境,745,68,9,822
2020-07-18,中国客运码头,入境,0,0,0,0
2020-07-18,中国客运码头,出境,0,0,0,0
2020-07-18,港口管制,入境,0,0,0,0
2020-07-18,港口管制,出境,0,0,0,0
2020-07-18,启德邮轮码头,入境,0,0,0,0
2020-07-18,启德邮轮码头,出境,0,0,0,0
2020-07-18,港澳客轮码头,入境,0,0,0,0
2020-07-18,港澳客轮码头,出境,0,0,0,0
2020-07-18,屯门客运码头,入境,0,0,0,0
2020-07-18,屯门客运码头,出境,0,0,0,0
2020-07-19,机场,入境,912,2,42,956
2020-07-19,机场,出境,1428,73,109,1610
2020-07-19,高铁西九龙,入境,0,0,0,0
2020-07-19,高铁西九龙,出境,0,0,0,0
2020-07-19,红磡,入境,0,0,0,0
2020-07-19,红磡,出境,0,0,0,0
2020-07-19,罗湖,入境,0,0,0,0
2020-07-19,罗湖,出境,0,0,0,0
2020-07-19,落马洲支线,入境,0,0,0,0
2020-07-19,落马洲支线,出境,0,0,0,0
2020-07-19,港珠澳大桥,入境,32,4,5,41
2020-07-19,港珠澳大桥,出境,141,5,4,150
2020-07-19,落马洲,入境,0,0,0,0
2020-07-19,落马洲,出境,0,0,0,0
2020-07-19,文锦渡,入境,0,0,0,0
2020-07-19,文锦渡,出境,0,0,0,0
2020-07-19,沙头角,入境,0,0,0,0
2020-07-19,沙头角,出境,0,0,0,0
2020-07-19,深圳湾,入境,435,78,7,520
2020-07-19,深圳湾,出境,674,109,7,790
2020-07-19,中国客运码头,入境,0,0,0,0
2020-07-19,中国客运码头,出境,0,0,0,0
2020-07-19,港口管制,入境,0,0,0,0
2020-07-19,港口管制,出境,0,0,0,0
2020-07-19,启德邮轮码头,入境,0,0,0,0
2020-07-19,启德邮轮码头,出境,0,0,0,0
2020-07-19,港澳客轮码头,入境,0,0,0,0
2020-07-19,港澳客轮码头,出境,0,0,0,0
2020-07-19,屯门客运码头,入境,0,0,0,0
2020-07-19,屯门客运码头,出境,0,0,0,0
2020-07-20,机场,入境,605,2,27,634
2020-07-20,机场,出境,794,41,113,948
2020-07-20,高铁西九龙,入境,0,0,0,0
2020-07-20,高铁西九龙,出境,0,0,0,0
2020-07-20,红磡,入境,0,0,0,0
2020-07-20,红磡,出境,0,0,0,0
2020-07-20,罗湖,入境,0,0,0,0
2020-07-20,罗湖,出境,0,0,0,0
2020-07-20,落马洲支线,入境,0,0,0,0
2020-07-20,落马洲支线,出境,0,0,0,0
2020-07-20,港珠澳大桥,入境,45,3,2,50
2020-07-20,港珠澳大桥,出境,156,11,2,169
2020-07-20,落马洲,入境,0,0,0,0
2020-07-20,落马洲,出境,0,0,0,0
2020-07-20,文锦渡,入境,0,0,0,0
2020-07-20,文锦渡,出境,0,0,0,0
2020-07-20,沙头角,入境,0,0,0,0
2020-07-20,沙头角,出境,0,0,0,0
2020-07-20,深圳湾,入境,535,68,12,615
2020-07-20,深圳湾,出境,798,114,18,930
2020-07-20,中国客运码头,入境,0,0,0,0
2020-07-20,中国客运码头,出境,0,0,0,0
2020-07-20,港口管制,入境,0,0,0,0
2020-07-20,港口管制,出境,0,0,0,0
2020-07-20,启德邮轮码头,入境,0,0,0,0
2020-07-20,启德邮轮码头,出境,0,0,0,0
2020-07-20,港澳客轮码头,入境,0,0,0,0
2020-07-20,港澳客轮码头,出境,0,0,0,0
2020-07-20,屯门客运码头,入境,0,0,0,0
2020-07-20,屯门客运码头,出境,0,0,0,0
2020-07-21,机场,入境,728,3,49,780
2020-07-21,机场,出境,1501,95,72,1668
2020-07-21,高铁西九龙,入境,0,0,0,0
2020-07-21,高铁西九龙,出境,0,0,0,0
2020-07-21,红磡,入境,0,0,0,0
2020-07-21,红磡,出境,0,0,0,0
2020-07-21,罗湖,入境,0,0,0,0
2020-07-21,罗湖,出境,0,0,0,0
2020-07-21,落马洲支线,入境,0,0,0,0
2020-07-21,落马洲支线,出境,0,0,0,0
2020-07-21,港珠澳大桥,入境,35,2,0,37
2020-07-21,港珠澳大桥,出境,200,12,3,215
2020-07-21,落马洲,入境,0,0,0,0
2020-07-21,落马洲,出境,0,0,0,0
2020-07-21,文锦渡,入境,0,0,0,0
2020-07-21,文锦渡,出境,0,0,0,0
2020-07-21,沙头角,入境,0,0,0,0
2020-07-21,沙头角,出境,0,0,0,0
2020-07-21,深圳湾,入境,386,45,6,437
2020-07-21,深圳湾,出境,1126,141,18,1285
2020-07-21,中国客运码头,入境,0,0,0,0
2020-07-21,中国客运码头,出境,0,0,0,0
2020-07-21,港口管制,入境,0,0,0,0
2020-07-21,港口管制,出境,0,0,0,0
2020-07-21,启德邮轮码头,入境,0,0,0,0
2020-07-21,启德邮轮码头,出境,0,0,0,0
2020-07-21,港澳客轮码头,入境,0,0,0,0
2020-07-21,港澳客轮码头,出境,0,0,0,0
2020-07-21,屯门客运码头,入境,0,0,0,0
2020-07-21,屯门客运码头,出境,0,0,0,0
2020-07-22,机场,入境,1089,3,47,1139
2020-07-22,机场,出境,1064,41,68,1173
2020-07-22,高铁西九龙,入境,0,0,0,0
2020-07-22,高铁西九龙,出境,0,0,0,0
2020-07-22,红磡,入境,0,0,0,0
2020-07-22,红磡,出境,0,0,0,0
2020-07-22,罗湖,入境,0,0,0,0
2020-07-22,罗湖,出境,0,0,0,0
2020-07-22,落马洲支线,入境,0,0,0,0
2020-07-22,落马洲支线,出境,0,0,0,0
2020-07-22,港珠澳大桥,入境,47,1,5,53
2020-07-22,港珠澳大桥,出境,279,26,5,310
2020-07-22,落马洲,入境,0,0,0,0
2020-07-22,落马洲,出境,0,0,0,0
2020-07-22,文锦渡,入境,0,0,0,0
2020-07-22,文锦渡,出境,0,0,0,0
2020-07-22,沙头角,入境,0,0,0,0
2020-07-22,沙头角,出境,0,0,0,0
2020-07-22,深圳湾,入境,326,46,6,378
2020-07-22,深圳湾,出境,1702,215,10,1927
2020-07-22,中国客运码头,入境,0,0,0,0
2020-07-22,中国客运码头,出境,0,0,0,0
2020-07-22,港口管制,入境,0,0,0,0
2020-07-22,港口管制,出境,0,0,0,0
2020-07-22,启德邮轮码头,入境,0,0,0,0
2020-07-22,启德邮轮码头,出境,0,0,0,0
2020-07-22,港澳客轮码头,入境,0,0,0,0
2020-07-22,港澳客轮码头,出境,0,0,0,0
2020-07-22,屯门客运码头,入境,0,0,0,0
2020-07-22,屯门客运码头,出境,0,0,0,0
2020-07-23,机场,入境,453,5,11,469
2020-07-23,机场,出境,1165,32,195,1392
2020-07-23,高铁西九龙,入境,0,0,0,0
2020-07-23,高铁西九龙,出境,0,0,0,0
2020-07-23,红磡,入境,0,0,0,0
2020-07-23,红磡,出境,0,0,0,0
2020-07-23,罗湖,入境,0,0,0,0
2020-07-23,罗湖,出境,0,0,0,0
2020-07-23,落马洲支线,入境,0,0,0,0
2020-07-23,落马洲支线,出境,0,0,0,0
2020-07-23,港珠澳大桥,入境,37,1,8,46
2020-07-23,港珠澳大桥,出境,252,20,5,277
2020-07-23,落马洲,入境,0,0,0,0
2020-07-23,落马洲,出境,0,0,0,0
2020-07-23,文锦渡,入境,0,0,0,0
2020-07-23,文锦渡,出境,0,0,0,0
2020-07-23,沙头角,入境,0,0,0,0
2020-07-23,沙头角,出境,0,0,0,0
2020-07-23,深圳湾,入境,301,37,20,358
2020-07-23,深圳湾,出境,1590,210,16,1816
2020-07-23,中国客运码头,入境,0,0,0,0
2020-07-23,中国客运码头,出境,0,0,0,0
2020-07-23,港口管制,入境,0,0,0,0
2020-07-23,港口管制,出境,0,0,0,0
2020-07-23,启德邮轮码头,入境,0,0,0,0
2020-07-23,启德邮轮码头,出境,0,0,0,0
2020-07-23,港澳客轮码头,入境,0,0,0,0
2020-07-23,港澳客轮码头,出境,0,0,0,0
2020-07-23,屯门客运码头,入境,0,0,0,0
2020-07-23,屯门客运码头,出境,0,0,0,0
2020-07-24,机场,入境,1069,5,42,1116
2020-07-24,机场,出境,1386,56,101,1543
2020-07-24,高铁西九龙,入境,0,0,0,0
2020-07-24,高铁西九龙,出境,0,0,0,0
2020-07-24,红磡,入境,0,0,0,0
2020-07-24,红磡,出境,0,0,0,0
2020-07-24,罗湖,入境,0,0,0,0
2020-07-24,罗湖,出境,0,0,0,0
2020-07-24,落马洲支线,入境,0,0,0,0
2020-07-24,落马洲支线,出境,0,0,0,0
2020-07-24,港珠澳大桥,入境,36,0,2,38
2020-07-24,港珠澳大桥,出境,250,18,13,281
2020-07-24,落马洲,入境,0,0,0,0
2020-07-24,落马洲,出境,0,0,0,0
2020-07-24,文锦渡,入境,0,0,0,0
2020-07-24,文锦渡,出境,0,0,0,0
2020-07-24,沙头角,入境,0,0,0,0
2020-07-24,沙头角,出境,0,0,0,0
2020-07-24,深圳湾,入境,277,48,0,325
2020-07-24,深圳湾,出境,1853,234,16,2103
2020-07-24,中国客运码头,入境,0,0,0,0
2020-07-24,中国客运码头,出境,0,0,0,0
2020-07-24,港口管制,入境,0,0,0,0
2020-07-24,港口管制,出境,0,0,0,0
2020-07-24,启德邮轮码头,入境,0,0,0,0
2020-07-24,启德邮轮码头,出境,0,0,0,0
2020-07-24,港澳客轮码头,入境,0,0,0,0
2020-07-24,港澳客轮码头,出境,0,0,0,0
2020-07-24,屯门客运码头,入境,0,0,0,0
2020-07-24,屯门客运码头,出境,0,0,0,0
2020-07-25,机场,入境,577,6,21,604
2020-07-25,机场,出境,1280,68,55,1403
2020-07-25,高铁西九龙,入境,0,0,0,0
2020-07-25,高铁西九龙,出境,0,0,0,0
2020-07-25,红磡,入境,0,0,0,0
2020-07-25,红磡,出境,0,0,0,0
2020-07-25,罗湖,入境,0,0,0,0
2020-07-25,罗湖,出境,0,0,0,0
2020-07-25,落马洲支线,入境,0,0,0,0
2020-07-25,落马洲支线,出境,0,0,0,0
2020-07-25,港珠澳大桥,入境,29,2,1,32
2020-07-25,港珠澳大桥,出境,252,17,4,273
2020-07-25,落马洲,入境,0,0,0,0
2020-07-25,落马洲,出境,0,0,0,0
2020-07-25,文锦渡,入境,0,0,0,0
2020-07-25,文锦渡,出境,0,0,0,0
2020-07-25,沙头角,入境,0,0,0,0
2020-07-25,沙头角,出境,0,0,0,0
2020-07-25,深圳湾,入境,300,51,5,356
2020-07-25,深圳湾,出境,1945,256,6,2207
2020-07-25,中国客运码头,入境,0,0,0,0
2020-07-25,中国客运码头,出境,0,0,0,0
2020-07-25,港口管制,入境,0,0,0,0
2020-07-25,港口管制,出境,0,0,0,0
2020-07-25,启德邮轮码头,入境,0,0,0,0
2020-07-25,启德邮轮码头,出境,0,0,0,0
2020-07-25,港澳客轮码头,入境,0,0,0,0
2020-07-25,港澳客轮码头,出境,0,0,0,0
2020-07-25,屯门客运码头,入境,0,0,0,0
2020-07-25,屯门客运码头,出境,0,0,0,0
2020-07-26,机场,入境,759,4,49,812
2020-07-26,机场,出境,1653,85,73,1811
2020-07-26,高铁西九龙,入境,0,0,0,0
2020-07-26,高铁西九龙,出境,0,0,0,0
2020-07-26,红磡,入境,0,0,0,0
2020-07-26,红磡,出境,0,0,0,0
2020-07-26,罗湖,入境,0,0,0,0
2020-07-26,罗湖,出境,0,0,0,0
2020-07-26,落马洲支线,入境,0,0,0,0
2020-07-26,落马洲支线,出境,0,0,0,0
2020-07-26,港珠澳大桥,入境,14,1,6,21
2020-07-26,港珠澳大桥,出境,244,20,4,268
2020-07-26,落马洲,入境,0,0,0,0
2020-07-26,落马洲,出境,0,0,0,0
2020-07-26,文锦渡,入境,0,0,0,0
2020-07-26,文锦渡,出境,0,0,0,0
2020-07-26,沙头角,入境,0,0,0,0
2020-07-26,沙头角,出境,0,0,0,0
2020-07-26,深圳湾,入境,280,33,8,321
2020-07-26,深圳湾,出境,999,113,7,1119
2020-07-26,中国客运码头,入境,0,0,0,0
2020-07-26,中国客运码头,出境,0,0,0,0
2020-07-26,港口管制,入境,0,0,0,0
2020-07-26,港口管制,出境,0,0,0,0
2020-07-26,启德邮轮码头,入境,0,0,0,0
2020-07-26,启德邮轮码头,出境,0,0,0,0
2020-07-26,港澳客轮码头,入境,0,0,0,0
2020-07-26,港澳客轮码头,出境,0,0,0,0
2020-07-26,屯门客运码头,入境,0,0,0,0
2020-07-26,屯门客运码头,出境,0,0,0,0
2020-07-27,机场,入境,517,5,25,547
2020-07-27,机场,出境,575,33,42,650
2020-07-27,高铁西九龙,入境,0,0,0,0
2020-07-27,高铁西九龙,出境,0,0,0,0
2020-07-27,红磡,入境,0,0,0,0
2020-07-27,红磡,出境,0,0,0,0
2020-07-27,罗湖,入境,0,0,0,0
2020-07-27,罗湖,出境,0,0,0,0
2020-07-27,落马洲支线,入境,0,0,0,0
2020-07-27,落马洲支线,出境,0,0,0,0
2020-07-27,港珠澳大桥,入境,21,3,4,28
2020-07-27,港珠澳大桥,出境,117,3,7,127
2020-07-27,落马洲,入境,0,0,0,0
2020-07-27,落马洲,出境,0,0,0,0
2020-07-27,文锦渡,入境,0,0,0,0
2020-07-27,文锦渡,出境,0,0,0,0
2020-07-27,沙头角,入境,0,0,0,0
2020-07-27,沙头角,出境,0,0,0,0
2020-07-27,深圳湾,入境,286,35,6,327
2020-07-27,深圳湾,出境,578,86,5,669
2020-07-27,中国客运码头,入境,0,0,0,0
2020-07-27,中国客运码头,出境,0,0,0,0
2020-07-27,港口管制,入境,0,0,0,0
2020-07-27,港口管制,出境,0,0,0,0
2020-07-27,启德邮轮码头,入境,0,0,0,0
2020-07-27,启德邮轮码头,出境,0,0,0,0
2020-07-27,港澳客轮码头,入境,0,0,0,0
2020-07-27,港澳客轮码头,出境,0,0,0,0
2020-07-27,屯门客运码头,入境,0,0,0,0
2020-07-27,屯门客运码头,出境,0,0,0,0
2020-07-28,机场,入境,869,10,47,926
2020-07-28,机场,出境,1379,62,84,1525
2020-07-28,高铁西九龙,入境,0,0,0,0
2020-07-28,高铁西九龙,出境,0,0,0,0
2020-07-28,红磡,入境,0,0,0,0
2020-07-28,红磡,出境,0,0,0,0
2020-07-28,罗湖,入境,0,0,0,0
2020-07-28,罗湖,出境,0,0,0,0
2020-07-28,落马洲支线,入境,0,0,0,0
2020-07-28,落马洲支线,出境,0,0,0,0
2020-07-28,港珠澳大桥,入境,21,0,8,29
2020-07-28,港珠澳大桥,出境,222,12,1,235
2020-07-28,落马洲,入境,0,0,0,0
2020-07-28,落马洲,出境,0,0,0,0
2020-07-28,文锦渡,入境,0,0,0,0
2020-07-28,文锦渡,出境,0,0,0,0
2020-07-28,沙头角,入境,0,0,0,0
2020-07-28,沙头角,出境,0,0,0,0
2020-07-28,深圳湾,入境,281,37,9,327
2020-07-28,深圳湾,出境,1098,125,6,1229
2020-07-28,中国客运码头,入境,0,0,0,0
2020-07-28,中国客运码头,出境,0,0,0,0
2020-07-28,港口管制,入境,0,0,0,0
2020-07-28,港口管制,出境,0,0,0,0
2020-07-28,启德邮轮码头,入境,0,0,0,0
2020-07-28,启德邮轮码头,出境,0,0,0,0
2020-07-28,港澳客轮码头,入境,0,0,0,0
2020-07-28,港澳客轮码头,出境,0,0,0,0
2020-07-28,屯门客运码头,入境,0,0,0,0
2020-07-28,屯门客运码头,出境,0,0,0,0
2020-07-29,机场,入境,333,0,23,356
2020-07-29,机场,出境,1143,28,53,1224
2020-07-29,高铁西九龙,入境,0,0,0,0
2020-07-29,高铁西九龙,出境,0,0,0,0
2020-07-29,红磡,入境,0,0,0,0
2020-07-29,红磡,出境,0,0,0,0
2020-07-29,罗湖,入境,0,0,0,0
2020-07-29,罗湖,出境,0,0,0,0
2020-07-29,落马洲支线,入境,0,0,0,0
2020-07-29,落马洲支线,出境,0,0,0,0
2020-07-29,港珠澳大桥,入境,36,0,7,43
2020-07-29,港珠澳大桥,出境,291,16,6,313
2020-07-29,落马洲,入境,0,0,0,0
2020-07-29,落马洲,出境,0,0,0,0
2020-07-29,文锦渡,入境,0,0,0,0
2020-07-29,文锦渡,出境,0,0,0,0
2020-07-29,沙头角,入境,0,0,0,0
2020-07-29,沙头角,出境,0,0,0,0
2020-07-29,深圳湾,入境,306,25,4,335
2020-07-29,深圳湾,出境,2295,267,14,2576
2020-07-29,中国客运码头,入境,0,0,0,0
2020-07-29,中国客运码头,出境,0,0,0,0
2020-07-29,港口管制,入境,0,0,0,0
2020-07-29,港口管制,出境,0,0,0,0
2020-07-29,启德邮轮码头,入境,0,0,0,0
2020-07-29,启德邮轮码头,出境,0,0,0,0
2020-07-29,港澳客轮码头,入境,0,0,0,0
2020-07-29,港澳客轮码头,出境,0,0,0,0
2020-07-29,屯门客运码头,入境,0,0,0,0
2020-07-29,屯门客运码头,出境,0,0,0,0
2020-07-30,机场,入境,250,3,20,273
2020-07-30,机场,出境,779,23,36,838
2020-07-30,高铁西九龙,入境,0,0,0,0
2020-07-30,高铁西九龙,出境,0,0,0,0
2020-07-30,红磡,入境,0,0,0,0
2020-07-30,红磡,出境,0,0,0,0
2020-07-30,罗湖,入境,0,0,0,0
2020-07-30,罗湖,出境,0,0,0,0
2020-07-30,落马洲支线,入境,0,0,0,0
2020-07-30,落马洲支线,出境,0,0,0,0
2020-07-30,港珠澳大桥,入境,39,2,1,42
2020-07-30,港珠澳大桥,出境,321,20,9,350
2020-07-30,落马洲,入境,0,0,0,0
2020-07-30,落马洲,出境,0,0,0,0
2020-07-30,文锦渡,入境,0,0,0,0
2020-07-30,文锦渡,出境,0,0,0,0
2020-07-30,沙头角,入境,0,0,0,0
2020-07-30,沙头角,出境,0,0,0,0
2020-07-30,深圳湾,入境,309,36,3,348
2020-07-30,深圳湾,出境,1941,228,3,2172
2020-07-30,中国客运码头,入境,0,0,0,0
2020-07-30,中国客运码头,出境,0,0,0,0
2020-07-30,港口管制,入境,0,0,0,0
2020-07-30,港口管制,出境,0,0,0,0
2020-07-30,启德邮轮码头,入境,0,0,0,0
2020-07-30,启德邮轮码头,出境,0,0,0,0
2020-07-30,港澳客轮码头,入境,0,0,0,0
2020-07-30,港澳客轮码头,出境,0,0,0,0
2020-07-30,屯门客运码头,入境,0,0,0,0
2020-07-30,屯门客运码头,出境,0,0,0,0
2020-07-31,机场,入境,568,3,65,636
2020-07-31,机场,出境,1681,57,98,1836
2020-07-31,高铁西九龙,入境,0,0,0,0
2020-07-31,高铁西九龙,出境,0,0,0,0
2020-07-31,红磡,入境,0,0,0,0
2020-07-31,红磡,出境,0,0,0,0
2020-07-31,罗湖,入境,0,0,0,0
2020-07-31,罗湖,出境,0,0,0,0
2020-07-31,落马洲支线,入境,0,0,0,0
2020-07-31,落马洲支线,出境,0,0,0,0
2020-07-31,港珠澳大桥,入境,56,1,4,61
2020-07-31,港珠澳大桥,出境,288,14,5,307
2020-07-31,落马洲,入境,0,0,0,0
2020-07-31,落马洲,出境,0,0,0,0
2020-07-31,文锦渡,入境,0,0,0,0
2020-07-31,文锦渡,出境,0,0,0,0
2020-07-31,沙头角,入境,0,0,0,0
2020-07-31,沙头角,出境,0,0,0,0
2020-07-31,深圳湾,入境,359,39,4,402
2020-07-31,深圳湾,出境,2336,301,4,2641
2020-07-31,中国客运码头,入境,0,0,0,0
2020-07-31,中国客运码头,出境,0,0,0,0
2020-07-31,港口管制,入境,0,0,0,0
2020-07-31,港口管制,出境,0,0,0,0
2020-07-31,启德邮轮码头,入境,0,0,0,0
2020-07-31,启德邮轮码头,出境,0,0,0,0
2020-07-31,港澳客轮码头,入境,0,0,0,0
2020-07-31,港澳客轮码头,出境,0,0,0,0
2020-07-31,屯门客运码头,入境,0,0,0,0
2020-07-31,屯门客运码头,出境,0,0,0,0
2020-08-01,机场,入境,571,5,11,587
2020-08-01,机场,出境,1800,80,82,1962
2020-08-01,高铁西九龙,入境,0,0,0,0
2020-08-01,高铁西九龙,出境,0,0,0,0
2020-08-01,红磡,入境,0,0,0,0
2020-08-01,红磡,出境,0,0,0,0
2020-08-01,罗湖,入境,0,0,0,0
2020-08-01,罗湖,出境,0,0,0,0
2020-08-01,落马洲支线,入境,0,0,0,0
2020-08-01,落马洲支线,出境,0,0,0,0
2020-08-01,港珠澳大桥,入境,29,1,4,34
2020-08-01,港珠澳大桥,出境,242,21,4,267
2020-08-01,落马洲,入境,0,0,0,0
2020-08-01,落马洲,出境,0,0,0,0
2020-08-01,文锦渡,入境,0,0,0,0
2020-08-01,文锦渡,出境,0,0,0,0
2020-08-01,沙头角,入境,0,0,0,0
2020-08-01,沙头角,出境,0,0,0,0
2020-08-01,深圳湾,入境,350,50,4,404
2020-08-01,深圳湾,出境,1861,219,10,2090
2020-08-01,中国客运码头,入境,0,0,0,0
2020-08-01,中国客运码头,出境,0,0,0,0
2020-08-01,港口管制,入境,0,0,0,0
2020-08-01,港口管制,出境,0,0,0,0
2020-08-01,启德邮轮码头,入境,0,0,0,0
2020-08-01,启德邮轮码头,出境,0,0,0,0
2020-08-01,港澳客轮码头,入境,0,0,0,0
2020-08-01,港澳客轮码头,出境,0,0,0,0
2020-08-01,屯门客运码头,入境,0,0,0,0
2020-08-01,屯门客运码头,出境,0,0,0,0
2020-08-02,机场,入境,674,3,46,723
2020-08-02,机场,出境,1663,59,96,1818
2020-08-02,高铁西九龙,入境,0,0,0,0
2020-08-02,高铁西九龙,出境,0,0,0,0
2020-08-02,红磡,入境,0,0,0,0
2020-08-02,红磡,出境,0,0,0,0
2020-08-02,罗湖,入境,0,0,0,0
2020-08-02,罗湖,出境,0,0,0,0
2020-08-02,落马洲支线,入境,0,0,0,0
2020-08-02,落马洲支线,出境,0,0,0,0
2020-08-02,港珠澳大桥,入境,32,2,8,42
2020-08-02,港珠澳大桥,出境,233,19,0,252
2020-08-02,落马洲,入境,0,0,0,0
2020-08-02,落马洲,出境,0,0,0,0
2020-08-02,文锦渡,入境,0,0,0,0
2020-08-02,文锦渡,出境,0,0,0,0
2020-08-02,沙头角,入境,0,0,0,0
2020-08-02,沙头角,出境,0,0,0,0
2020-08-02,深圳湾,入境,338,29,5,372
2020-08-02,深圳湾,出境,1032,106,4,1142
2020-08-02,中国客运码头,入境,0,0,0,0
2020-08-02,中国客运码头,出境,0,0,0,0
2020-08-02,港口管制,入境,0,0,0,0
2020-08-02,港口管制,出境,0,0,0,0
2020-08-02,启德邮轮码头,入境,0,0,0,0
2020-08-02,启德邮轮码头,出境,0,0,0,0
2020-08-02,港澳客轮码头,入境,0,0,0,0
2020-08-02,港澳客轮码头,出境,0,0,0,0
2020-08-02,屯门客运码头,入境,0,0,0,0
2020-08-02,屯门客运码头,出境,0,0,0,0
2020-08-03,机场,入境,416,2,14,432
2020-08-03,机场,出境,883,24,112,1019
2020-08-03,高铁西九龙,入境,0,0,0,0
2020-08-03,高铁西九龙,出境,0,0,0,0
2020-08-03,红磡,入境,0,0,0,0
2020-08-03,红磡,出境,0,0,0,0
2020-08-03,罗湖,入境,0,0,0,0
2020-08-03,罗湖,出境,0,0,0,0
2020-08-03,落马洲支线,入境,0,0,0,0
2020-08-03,落马洲支线,出境,0,0,0,0
2020-08-03,港珠澳大桥,入境,28,4,11,43
2020-08-03,港珠澳大桥,出境,157,4,2,163
2020-08-03,落马洲,入境,0,0,0,0
2020-08-03,落马洲,出境,0,0,0,0
2020-08-03,文锦渡,入境,0,0,0,0
2020-08-03,文锦渡,出境,0,0,0,0
2020-08-03,沙头角,入境,0,0,0,0
2020-08-03,沙头角,出境,0,0,0,0
2020-08-03,深圳湾,入境,428,22,9,459
2020-08-03,深圳湾,出境,498,61,1,560
2020-08-03,中国客运码头,入境,0,0,0,0
2020-08-03,中国客运码头,出境,0,0,0,0
2020-08-03,港口管制,入境,0,0,0,0
2020-08-03,港口管制,出境,0,0,0,0
2020-08-03,启德邮轮码头,入境,0,0,0,0
2020-08-03,启德邮轮码头,出境,0,0,0,0
2020-08-03,港澳客轮码头,入境,0,0,0,0
2020-08-03,港澳客轮码头,出境,0,0,0,0
2020-08-03,屯门客运码头,入境,0,0,0,0
2020-08-03,屯门客运码头,出境,0,0,0,0
2020-08-04,机场,入境,693,3,34,730
2020-08-04,机场,出境,1440,61,91,1592
2020-08-04,高铁西九龙,入境,0,0,0,0
2020-08-04,高铁西九龙,出境,0,0,0,0
2020-08-04,红磡,入境,0,0,0,0
2020-08-04,红磡,出境,0,0,0,0
2020-08-04,罗湖,入境,0,0,0,0
2020-08-04,罗湖,出境,0,0,0,0
2020-08-04,落马洲支线,入境,0,0,0,0
2020-08-04,落马洲支线,出境,0,0,0,0
2020-08-04,港珠澳大桥,入境,29,2,5,36
2020-08-04,港珠澳大桥,出境,188,21,7,216
2020-08-04,落马洲,入境,0,0,0,0
2020-08-04,落马洲,出境,0,0,0,0
2020-08-04,文锦渡,入境,0,0,0,0
2020-08-04,文锦渡,出境,0,0,0,0
2020-08-04,沙头角,入境,0,0,0,0
2020-08-04,沙头角,出境,0,0,0,0
2020-08-04,深圳湾,入境,312,30,6,348
2020-08-04,深圳湾,出境,939,103,6,1048
2020-08-04,中国客运码头,入境,0,0,0,0
2020-08-04,中国客运码头,出境,0,0,0,0
2020-08-04,港口管制,入境,0,0,0,0
2020-08-04,港口管制,出境,0,0,0,0
2020-08-04,启德邮轮码头,入境,0,0,0,0
2020-08-04,启德邮轮码头,出境,0,0,0,0
2020-08-04,港澳客轮码头,入境,0,0,0,0
2020-08-04,港澳客轮码头,出境,0,0,0,0
2020-08-04,屯门客运码头,入境,0,0,0,0
2020-08-04,屯门客运码头,出境,0,0,0,0
2020-08-05,机场,入境,683,3,40,726
2020-08-05,机场,出境,857,27,42,926
2020-08-05,高铁西九龙,入境,0,0,0,0
2020-08-05,高铁西九龙,出境,0,0,0,0
2020-08-05,红磡,入境,0,0,0,0
2020-08-05,红磡,出境,0,0,0,0
2020-08-05,罗湖,入境,0,0,0,0
2020-08-05,罗湖,出境,0,0,0,0
2020-08-05,落马洲支线,入境,0,0,0,0
2020-08-05,落马洲支线,出境,0,0,0,0
2020-08-05,港珠澳大桥,入境,31,0,8,39
2020-08-05,港珠澳大桥,出境,255,14,10,279
2020-08-05,落马洲,入境,0,0,0,0
2020-08-05,落马洲,出境,0,0,0,0
2020-08-05,文锦渡,入境,0,0,0,0
2020-08-05,文锦渡,出境,0,0,0,0
2020-08-05,沙头角,入境,0,0,0,0
2020-08-05,沙头角,出境,0,0,0,0
2020-08-05,深圳湾,入境,301,29,6,336
2020-08-05,深圳湾,出境,1832,226,6,2064
2020-08-05,中国客运码头,入境,0,0,0,0
2020-08-05,中国客运码头,出境,0,0,0,0
2020-08-05,港口管制,入境,0,0,0,0
2020-08-05,港口管制,出境,0,0,0,0
2020-08-05,启德邮轮码头,入境,0,0,0,0
2020-08-05,启德邮轮码头,出境,0,0,0,0
2020-08-05,港澳客轮码头,入境,0,0,0,0
2020-08-05,港澳客轮码头,出境,0,0,0,0
2020-08-05,屯门客运码头,入境,0,0,0,0
2020-08-05,屯门客运码头,出境,0,0,0,0
2020-08-06,机场,入境,373,3,20,396
2020-08-06,机场,出境,1195,32,99,1326
2020-08-06,高铁西九龙,入境,0,0,0,0
2020-08-06,高铁西九龙,出境,0,0,0,0
2020-08-06,红磡,入境,0,0,0,0
2020-08-06,红磡,出境,0,0,0,0
2020-08-06,罗湖,入境,0,0,0,0
2020-08-06,罗湖,出境,0,0,0,0
2020-08-06,落马洲支线,入境,0,0,0,0
2020-08-06,落马洲支线,出境,0,0,0,0
2020-08-06,港珠澳大桥,入境,41,2,5,48
2020-08-06,港珠澳大桥,出境,284,14,7,305
2020-08-06,落马洲,入境,0,0,0,0
2020-08-06,落马洲,出境,0,0,0,0
2020-08-06,文锦渡,入境,0,0,0,0
2020-08-06,文锦渡,出境,0,0,0,0
2020-08-06,沙头角,入境,0,0,0,0
2020-08-06,沙头角,出境,0,0,0,0
2020-08-06,深圳湾,入境,347,37,2,386
2020-08-06,深圳湾,出境,2262,302,5,2569
2020-08-06,中国客运码头,入境,0,0,0,0
2020-08-06,中国客运码头,出境,0,0,0,0
2020-08-06,港口管制,入境,0,0,0,0
2020-08-06,港口管制,出境,0,0,0,0
2020-08-06,启德邮轮码头,入境,0,0,0,0
2020-08-06,启德邮轮码头,出境,0,0,0,0
2020-08-06,港澳客轮码头,入境,0,0,0,0
2020-08-06,港澳客轮码头,出境,0,0,0,0
2020-08-06,屯门客运码头,入境,0,0,0,0
2020-08-06,屯门客运码头,出境,0,0,0,0
2020-08-07,机场,入境,672,5,46,723
2020-08-07,机场,出境,1312,32,117,1461
2020-08-07,高铁西九龙,入境,0,0,0,0
2020-08-07,高铁西九龙,出境,0,0,0,0
2020-08-07,红磡,入境,0,0,0,0
2020-08-07,红磡,出境,0,0,0,0
2020-08-07,罗湖,入境,0,0,0,0
2020-08-07,罗湖,出境,0,0,0,0
2020-08-07,落马洲支线,入境,0,0,0,0
2020-08-07,落马洲支线,出境,0,0,0,0
2020-08-07,港珠澳大桥,入境,26,1,10,37
2020-08-07,港珠澳大桥,出境,149,12,8,169
2020-08-07,落马洲,入境,0,0,0,0
2020-08-07,落马洲,出境,0,0,0,0
2020-08-07,文锦渡,入境,0,0,0,0
2020-08-07,文锦渡,出境,0,0,0,0
2020-08-07,沙头角,入境,0,0,0,0
2020-08-07,沙头角,出境,0,0,0,0
2020-08-07,深圳湾,入境,411,32,6,449
2020-08-07,深圳湾,出境,931,108,2,1041
2020-08-07,中国客运码头,入境,0,0,0,0
2020-08-07,中国客运码头,出境,0,0,0,0
2020-08-07,港口管制,入境,0,0,0,0
2020-08-07,港口管制,出境,0,0,0,0
2020-08-07,启德邮轮码头,入境,0,0,0,0
2020-08-07,启德邮轮码头,出境,0,0,0,0
2020-08-07,港澳客轮码头,入境,0,0,0,0
2020-08-07,港澳客轮码头,出境,0,0,0,0
2020-08-07,屯门客运码头,入境,0,0,0,0
2020-08-07,屯门客运码头,出境,0,0,0,0
2020-08-08,机场,入境,646,5,22,673
2020-08-08,机场,出境,1594,65,56,1715
2020-08-08,高铁西九龙,入境,0,0,0,0
2020-08-08,高铁西九龙,出境,0,0,0,0
2020-08-08,红磡,入境,0,0,0,0
2020-08-08,红磡,出境,0,0,0,0
2020-08-08,罗湖,入境,0,0,0,0
2020-08-08,罗湖,出境,0,0,0,0
2020-08-08,落马洲支线,入境,0,0,0,0
2020-08-08,落马洲支线,出境,0,0,0,0
2020-08-08,港珠澳大桥,入境,38,3,5,46
2020-08-08,港珠澳大桥,出境,181,15,4,200
2020-08-08,落马洲,入境,0,0,0,0
2020-08-08,落马洲,出境,0,0,0,0
2020-08-08,文锦渡,入境,0,0,0,0
2020-08-08,文锦渡,出境,0,0,0,0
2020-08-08,沙头角,入境,0,0,0,0
2020-08-08,沙头角,出境,0,0,0,0
2020-08-08,深圳湾,入境,370,51,7,428
2020-08-08,深圳湾,出境,852,105,1,958
2020-08-08,中国客运码头,入境,0,0,0,0
2020-08-08,中国客运码头,出境,0,0,0,0
2020-08-08,港口管制,入境,0,0,0,0
2020-08-08,港口管制,出境,0,0,0,0
2020-08-08,启德邮轮码头,入境,0,0,0,0
2020-08-08,启德邮轮码头,出境,0,0,0,0
2020-08-08,港澳客轮码头,入境,0,0,0,0
2020-08-08,港澳客轮码头,出境,0,0,0,0
2020-08-08,屯门客运码头,入境,0,0,0,0
2020-08-08,屯门客运码头,出境,0,0,0,0
2020-08-09,机场,入境,621,10,28,659
2020-08-09,机场,出境,1522,47,84,1653
2020-08-09,高铁西九龙,入境,0,0,0,0
2020-08-09,高铁西九龙,出境,0,0,0,0
2020-08-09,红磡,入境,0,0,0,0
2020-08-09,红磡,出境,0,0,0,0
2020-08-09,罗湖,入境,0,0,0,0
2020-08-09,罗湖,出境,0,0,0,0
2020-08-09,落马洲支线,入境,0,0,0,0
2020-08-09,落马洲支线,出境,0,0,0,0
2020-08-09,港珠澳大桥,入境,42,4,6,52
2020-08-09,港珠澳大桥,出境,113,6,3,122
2020-08-09,落马洲,入境,0,0,0,0
2020-08-09,落马洲,出境,0,0,0,0
2020-08-09,文锦渡,入境,0,0,0,0
2020-08-09,文锦渡,出境,0,0,0,0
2020-08-09,沙头角,入境,0,0,0,0
2020-08-09,沙头角,出境,0,0,0,0
2020-08-09,深圳湾,入境,415,37,1,453
2020-08-09,深圳湾,出境,646,78,2,726
2020-08-09,中国客运码头,入境,0,0,0,0
2020-08-09,中国客运码头,出境,0,0,0,0
2020-08-09,港口管制,入境,0,0,0,0
2020-08-09,港口管制,出境,0,0,0,0
2020-08-09,启德邮轮码头,入境,0,0,0,0
2020-08-09,启德邮轮码头,出境,0,0,0,0
2020-08-09,港澳客轮码头,入境,0,0,0,0
2020-08-09,港澳客轮码头,出境,0,0,0,0
2020-08-09,屯门客运码头,入境,0,0,0,0
2020-08-09,屯门客运码头,出境,0,0,0,0
2020-08-10,机场,入境,528,10,22,560
2020-08-10,机场,出境,749,19,78,846
2020-08-10,高铁西九龙,入境,0,0,0,0
2020-08-10,高铁西九龙,出境,0,0,0,0
2020-08-10,红磡,入境,0,0,0,0
2020-08-10,红磡,出境,0,0,0,0
2020-08-10,罗湖,入境,0,0,0,0
2020-08-10,罗湖,出境,0,0,0,0
2020-08-10,落马洲支线,入境,0,0,0,0
2020-08-10,落马洲支线,出境,0,0,0,0
2020-08-10,港珠澳大桥,入境,33,3,7,43
2020-08-10,港珠澳大桥,出境,98,3,4,105
2020-08-10,落马洲,入境,0,0,0,0
2020-08-10,落马洲,出境,0,0,0,0
2020-08-10,文锦渡,入境,0,0,0,0
2020-08-10,文锦渡,出境,0,0,0,0
2020-08-10,沙头角,入境,0,0,0,0
2020-08-10,沙头角,出境,0,0,0,0
2020-08-10,深圳湾,入境,530,43,2,575
2020-08-10,深圳湾,出境,500,49,1,550
2020-08-10,中国客运码头,入境,0,0,0,0
2020-08-10,中国客运码头,出境,0,0,0,0
2020-08-10,港口管制,入境,0,0,0,0
2020-08-10,港口管制,出境,0,0,0,0
2020-08-10,启德邮轮码头,入境,0,0,0,0
2020-08-10,启德邮轮码头,出境,0,0,0,0
2020-08-10,港澳客轮码头,入境,0,0,0,0
2020-08-10,港澳客轮码头,出境,0,0,0,0
2020-08-10,屯门客运码头,入境,0,0,0,0
2020-08-10,屯门客运码头,出境,0,0,0,0
2020-08-11,机场,入境,798,2,33,833
2020-08-11,机场,出境,988,23,57,1068
2020-08-11,高铁西九龙,入境,0,0,0,0
2020-08-11,高铁西九龙,出境,0,0,0,0
2020-08-11,红磡,入境,0,0,0,0
2020-08-11,红磡,出境,0,0,0,0
2020-08-11,罗湖,入境,0,0,0,0
2020-08-11,罗湖,出境,0,0,0,0
2020-08-11,落马洲支线,入境,0,0,0,0
2020-08-11,落马洲支线,出境,0,0,0,0
2020-08-11,港珠澳大桥,入境,23,1,2,26
2020-08-11,港珠澳大桥,出境,167,4,3,174
2020-08-11,落马洲,入境,0,0,0,0
2020-08-11,落马洲,出境,0,0,0,0
2020-08-11,文锦渡,入境,0,0,0,0
2020-08-11,文锦渡,出境,0,0,0,0
2020-08-11,沙头角,入境,0,0,0,0
2020-08-11,沙头角,出境,0,0,0,0
2020-08-11,深圳湾,入境,383,44,3,430
2020-08-11,深圳湾,出境,884,111,4,999
2020-08-11,中国客运码头,入境,0,0,0,0
2020-08-11,中国客运码头,出境,0,0,0,0
2020-08-11,港口管制,入境,0,0,0,0
2020-08-11,港口管制,出境,0,0,0,0
2020-08-11,启德邮轮码头,入境,0,0,0,0
2020-08-11,启德邮轮码头,出境,0,0,0,0
2020-08-11,港澳客轮码头,入境,0,0,0,0
2020-08-11,港澳客轮码头,出境,0,0,0,0
2020-08-11,屯门客运码头,入境,0,0,0,0
2020-08-11,屯门客运码头,出境,0,0,0,0
2020-08-12,机场,入境,388,7,21,416
2020-08-12,机场,出境,922,24,43,989
2020-08-12,高铁西九龙,入境,0,0,0,0
2020-08-12,高铁西九龙,出境,0,0,0,0
2020-08-12,红磡,入境,0,0,0,0
2020-08-12,红磡,出境,0,0,0,0
2020-08-12,罗湖,入境,0,0,0,0
2020-08-12,罗湖,出境,0,0,0,0
2020-08-12,落马洲支线,入境,0,0,0,0
2020-08-12,落马洲支线,出境,0,0,0,0
2020-08-12,港珠澳大桥,入境,40,0,5,45
2020-08-12,港珠澳大桥,出境,203,23,3,229
2020-08-12,落马洲,入境,0,0,0,0
2020-08-12,落马洲,出境,0,0,0,0
2020-08-12,文锦渡,入境,0,0,0,0
2020-08-12,文锦渡,出境,0,0,0,0
2020-08-12,沙头角,入境,0,0,0,0
2020-08-12,沙头角,出境,0,0,0,0
2020-08-12,深圳湾,入境,504,51,8,563
2020-08-12,深圳湾,出境,1062,169,4,1235
2020-08-12,中国客运码头,入境,0,0,0,0
2020-08-12,中国客运码头,出境,0,0,0,0
2020-08-12,港口管制,入境,0,0,0,0
2020-08-12,港口管制,出境,0,0,0,0
2020-08-12,启德邮轮码头,入境,0,0,0,0
2020-08-12,启德邮轮码头,出境,0,0,0,0
2020-08-12,港澳客轮码头,入境,0,0,0,0
2020-08-12,港澳客轮码头,出境,0,0,0,0
2020-08-12,屯门客运码头,入境,0,0,0,0
2020-08-12,屯门客运码头,出境,0,0,0,0
2020-08-13,机场,入境,532,2,16,550
2020-08-13,机场,出境,1179,15,61,1255
2020-08-13,高铁西九龙,入境,0,0,0,0
2020-08-13,高铁西九龙,出境,0,0,0,0
2020-08-13,红磡,入境,0,0,0,0
2020-08-13,红磡,出境,0,0,0,0
2020-08-13,罗湖,入境,0,0,0,0
2020-08-13,罗湖,出境,0,0,0,0
2020-08-13,落马洲支线,入境,0,0,0,0
2020-08-13,落马洲支线,出境,0,0,0,0
2020-08-13,港珠澳大桥,入境,38,3,6,47
2020-08-13,港珠澳大桥,出境,194,10,5,209
2020-08-13,落马洲,入境,0,0,0,0
2020-08-13,落马洲,出境,0,0,0,0
2020-08-13,文锦渡,入境,0,0,0,0
2020-08-13,文锦渡,出境,0,0,0,0
2020-08-13,沙头角,入境,0,0,0,0
2020-08-13,沙头角,出境,0,0,0,0
2020-08-13,深圳湾,入境,571,53,3,627
2020-08-13,深圳湾,出境,1035,156,4,1195
2020-08-13,中国客运码头,入境,0,0,0,0
2020-08-13,中国客运码头,出境,0,0,0,0
2020-08-13,港口管制,入境,0,0,0,0
2020-08-13,港口管制,出境,0,0,0,0
2020-08-13,启德邮轮码头,入境,0,0,0,0
2020-08-13,启德邮轮码头,出境,0,0,0,0
2020-08-13,港澳客轮码头,入境,0,0,0,0
2020-08-13,港澳客轮码头,出境,0,0,0,0
2020-08-13,屯门客运码头,入境,0,0,0,0
2020-08-13,屯门客运码头,出境,0,0,0,0
2020-08-14,机场,入境,793,3,49,845
2020-08-14,机场,出境,1565,23,88,1676
2020-08-14,高铁西九龙,入境,0,0,0,0
2020-08-14,高铁西九龙,出境,0,0,0,0
2020-08-14,红磡,入境,0,0,0,0
2020-08-14,红磡,出境,0,0,0,0
2020-08-14,罗湖,入境,0,0,0,0
2020-08-14,罗湖,出境,0,0,0,0
2020-08-14,落马洲支线,入境,0,0,0,0
2020-08-14,落马洲支线,出境,0,0,0,0
2020-08-14,港珠澳大桥,入境,51,1,7,59
2020-08-14,港珠澳大桥,出境,188,7,7,202
2020-08-14,落马洲,入境,0,0,0,0
2020-08-14,落马洲,出境,0,0,0,0
2020-08-14,文锦渡,入境,0,0,0,0
2020-08-14,文锦渡,出境,0,0,0,0
2020-08-14,沙头角,入境,0,0,0,0
2020-08-14,沙头角,出境,0,0,0,0
2020-08-14,深圳湾,入境,500,48,2,550
2020-08-14,深圳湾,出境,880,85,5,970
2020-08-14,中国客运码头,入境,0,0,0,0
2020-08-14,中国客运码头,出境,0,0,0,0
2020-08-14,港口管制,入境,0,0,0,0
2020-08-14,港口管制,出境,0,0,0,0
2020-08-14,启德邮轮码头,入境,0,0,0,0
2020-08-14,启德邮轮码头,出境,0,0,0,0
2020-08-14,港澳客轮码头,入境,0,0,0,0
2020-08-14,港澳客轮码头,出境,0,0,0,0
2020-08-14,屯门客运码头,入境,0,0,0,0
2020-08-14,屯门客运码头,出境,0,0,0,0
2020-08-15,机场,入境,745,5,39,789
2020-08-15,机场,出境,1636,44,195,1875
2020-08-15,高铁西九龙,入境,0,0,0,0
2020-08-15,高铁西九龙,出境,0,0,0,0
2020-08-15,红磡,入境,0,0,0,0
2020-08-15,红磡,出境,0,0,0,0
2020-08-15,罗湖,入境,0,0,0,0
2020-08-15,罗湖,出境,0,0,0,0
2020-08-15,落马洲支线,入境,0,0,0,0
2020-08-15,落马洲支线,出境,0,0,0,0
2020-08-15,港珠澳大桥,入境,46,9,33,88
2020-08-15,港珠澳大桥,出境,152,6,4,162
2020-08-15,落马洲,入境,0,0,0,0
2020-08-15,落马洲,出境,0,0,0,0
2020-08-15,文锦渡,入境,0,0,0,0
2020-08-15,文锦渡,出境,0,0,0,0
2020-08-15,沙头角,入境,0,0,0,0
2020-08-15,沙头角,出境,0,0,0,0
2020-08-15,深圳湾,入境,629,76,6,711
2020-08-15,深圳湾,出境,774,108,7,889
2020-08-15,中国客运码头,入境,0,0,0,0
2020-08-15,中国客运码头,出境,0,0,0,0
2020-08-15,港口管制,入境,0,0,0,0
2020-08-15,港口管制,出境,0,0,0,0
2020-08-15,启德邮轮码头,入境,0,0,0,0
2020-08-15,启德邮轮码头,出境,0,0,0,0
2020-08-15,港澳客轮码头,入境,0,0,0,0
2020-08-15,港澳客轮码头,出境,0,0,0,0
2020-08-15,屯门客运码头,入境,0,0,0,0
2020-08-15,屯门客运码头,出境,0,0,0,0
2020-08-16,机场,入境,786,11,21,818
2020-08-16,机场,出境,1595,35,74,1704
2020-08-16,高铁西九龙,入境,0,0,0,0
2020-08-16,高铁西九龙,出境,0,0,0,0
2020-08-16,红磡,入境,0,0,0,0
2020-08-16,红磡,出境,0,0,0,0
2020-08-16,罗湖,入境,0,0,0,0
2020-08-16,罗湖,出境,0,0,0,0
2020-08-16,落马洲支线,入境,0,0,0,0
2020-08-16,落马洲支线,出境,0,0,0,0
2020-08-16,港珠澳大桥,入境,51,3,1,55
2020-08-16,港珠澳大桥,出境,113,7,6,126
2020-08-16,落马洲,入境,0,0,0,0
2020-08-16,落马洲,出境,0,0,0,0
2020-08-16,文锦渡,入境,0,0,0,0
2020-08-16,文锦渡,出境,0,0,0,0
2020-08-16,沙头角,入境,0,0,0,0
2020-08-16,沙头角,出境,0,0,0,0
2020-08-16,深圳湾,入境,699,57,6,762
2020-08-16,深圳湾,出境,659,69,2,730
2020-08-16,中国客运码头,入境,0,0,0,0
2020-08-16,中国客运码头,出境,0,0,0,0
2020-08-16,港口管制,入境,0,0,0,0
2020-08-16,港口管制,出境,0,0,0,0
2020-08-16,启德邮轮码头,入境,0,0,0,0
2020-08-16,启德邮轮码头,出境,0,0,0,0
2020-08-16,港澳客轮码头,入境,0,0,0,0
2020-08-16,港澳客轮码头,出境,0,0,0,0
2020-08-16,屯门客运码头,入境,0,0,0,0
2020-08-16,屯门客运码头,出境,0,0,0,0
2020-08-17,机场,入境,690,6,22,718
2020-08-17,机场,出境,913,15,32,960
2020-08-17,高铁西九龙,入境,0,0,0,0
2020-08-17,高铁西九龙,出境,0,0,0,0
2020-08-17,红磡,入境,0,0,0,0
2020-08-17,红磡,出境,0,0,0,0
2020-08-17,罗湖,入境,0,0,0,0
2020-08-17,罗湖,出境,0,0,0,0
2020-08-17,落马洲支线,入境,0,0,0,0
2020-08-17,落马洲支线,出境,0,0,0,0
2020-08-17,港珠澳大桥,入境,48,0,7,55
2020-08-17,港珠澳大桥,出境,96,5,3,104
2020-08-17,落马洲,入境,0,0,0,0
2020-08-17,落马洲,出境,0,0,0,0
2020-08-17,文锦渡,入境,0,0,0,0
2020-08-17,文锦渡,出境,0,0,0,0
2020-08-17,沙头角,入境,0,0,0,0
2020-08-17,沙头角,出境,0,0,0,0
2020-08-17,深圳湾,入境,710,71,1,782
2020-08-17,深圳湾,出境,443,46,1,490
2020-08-17,中国客运码头,入境,0,0,0,0
2020-08-17,中国客运码头,出境,0,0,0,0
2020-08-17,港口管制,入境,0,0,0,0
2020-08-17,港口管制,出境,0,0,0,0
2020-08-17,启德邮轮码头,入境,0,0,0,0
2020-08-17,启德邮轮码头,出境,0,0,0,0
2020-08-17,港澳客轮码头,入境,0,0,0,0
2020-08-17,港澳客轮码头,出境,0,0,0,0
2020-08-17,屯门客运码头,入境,0,0,0,0
2020-08-17,屯门客运码头,出境,0,0,0,0
2020-08-18,机场,入境,435,0,14,449
2020-08-18,机场,出境,1253,19,48,1320
2020-08-18,高铁西九龙,入境,0,0,0,0
2020-08-18,高铁西九龙,出境,0,0,0,0
2020-08-18,红磡,入境,0,0,0,0
2020-08-18,红磡,出境,0,0,0,0
2020-08-18,罗湖,入境,0,0,0,0
2020-08-18,罗湖,出境,0,0,0,0
2020-08-18,落马洲支线,入境,0,0,0,0
2020-08-18,落马洲支线,出境,0,0,0,0
2020-08-18,港珠澳大桥,入境,57,1,7,65
2020-08-18,港珠澳大桥,出境,150,10,8,168
2020-08-18,落马洲,入境,0,0,0,0
2020-08-18,落马洲,出境,0,0,0,0
2020-08-18,文锦渡,入境,0,0,0,0
2020-08-18,文锦渡,出境,0,0,0,0
2020-08-18,沙头角,入境,0,0,0,0
2020-08-18,沙头角,出境,0,0,0,0
2020-08-18,深圳湾,入境,673,49,2,724
2020-08-18,深圳湾,出境,782,78,3,863
2020-08-18,中国客运码头,入境,0,0,0,0
2020-08-18,中国客运码头,出境,0,0,0,0
2020-08-18,港口管制,入境,0,0,0,0
2020-08-18,港口管制,出境,0,0,0,0
2020-08-18,启德邮轮码头,入境,0,0,0,0
2020-08-18,启德邮轮码头,出境,0,0,0,0
2020-08-18,港澳客轮码头,入境,0,0,0,0
2020-08-18,港澳客轮码头,出境,0,0,0,0
2020-08-18,屯门客运码头,入境,0,0,0,0
2020-08-18,屯门客运码头,出境,0,0,0,0
2020-08-19,机场,入境,501,1,21,523
2020-08-19,机场,出境,870,10,33,913
2020-08-19,高铁西九龙,入境,0,0,0,0
2020-08-19,高铁西九龙,出境,0,0,0,0
2020-08-19,红磡,入境,0,0,0,0
2020-08-19,红磡,出境,0,0,0,0
2020-08-19,罗湖,入境,0,0,0,0
2020-08-19,罗湖,出境,0,0,0,0
2020-08-19,落马洲支线,入境,0,0,0,0
2020-08-19,落马洲支线,出境,0,0,0,0
2020-08-19,港珠澳大桥,入境,17,0,2,19
2020-08-19,港珠澳大桥,出境,79,3,1,83
2020-08-19,落马洲,入境,0,0,0,0
2020-08-19,落马洲,出境,0,0,0,0
2020-08-19,文锦渡,入境,0,0,0,0
2020-08-19,文锦渡,出境,0,0,0,0
2020-08-19,沙头角,入境,0,0,0,0
2020-08-19,沙头角,出境,0,0,0,0
2020-08-19,深圳湾,入境,359,27,5,391
2020-08-19,深圳湾,出境,806,111,1,918
2020-08-19,中国客运码头,入境,0,0,0,0
2020-08-19,中国客运码头,出境,0,0,0,0
2020-08-19,港口管制,入境,0,0,0,0
2020-08-19,港口管制,出境,0,0,0,0
2020-08-19,启德邮轮码头,入境,0,0,0,0
2020-08-19,启德邮轮码头,出境,0,0,0,0
2020-08-19,港澳客轮码头,入境,0,0,0,0
2020-08-19,港澳客轮码头,出境,0,0,0,0
2020-08-19,屯门客运码头,入境,0,0,0,0
2020-08-19,屯门客运码头,出境,0,0,0,0
2020-08-20,机场,入境,712,1,29,742
2020-08-20,机场,出境,1260,6,54,1320
2020-08-20,高铁西九龙,入境,0,0,0,0
2020-08-20,高铁西九龙,出境,0,0,0,0
2020-08-20,红磡,入境,0,0,0,0
2020-08-20,红磡,出境,0,0,0,0
2020-08-20,罗湖,入境,0,0,0,0
2020-08-20,罗湖,出境,0,0,0,0
2020-08-20,落马洲支线,入境,0,0,0,0
2020-08-20,落马洲支线,出境,0,0,0,0
2020-08-20,港珠澳大桥,入境,43,2,12,57
2020-08-20,港珠澳大桥,出境,142,3,6,151
2020-08-20,落马洲,入境,0,0,0,0
2020-08-20,落马洲,出境,0,0,0,0
2020-08-20,文锦渡,入境,0,0,0,0
2020-08-20,文锦渡,出境,0,0,0,0
2020-08-20,沙头角,入境,0,0,0,0
2020-08-20,沙头角,出境,0,0,0,0
2020-08-20,深圳湾,入境,605,84,2,691
2020-08-20,深圳湾,出境,741,98,5,844
2020-08-20,中国客运码头,入境,0,0,0,0
2020-08-20,中国客运码头,出境,0,0,0,0
2020-08-20,港口管制,入境,0,0,0,0
2020-08-20,港口管制,出境,0,0,0,0
2020-08-20,启德邮轮码头,入境,0,0,0,0
2020-08-20,启德邮轮码头,出境,0,0,0,0
2020-08-20,港澳客轮码头,入境,0,0,0,0
2020-08-20,港澳客轮码头,出境,0,0,0,0
2020-08-20,屯门客运码头,入境,0,0,0,0
2020-08-20,屯门客运码头,出境,0,0,0,0
2020-08-21,机场,入境,722,10,25,757
2020-08-21,机场,出境,1681,27,184,1892
2020-08-21,高铁西九龙,入境,0,0,0,0
2020-08-21,高铁西九龙,出境,0,0,0,0
2020-08-21,红磡,入境,0,0,0,0
2020-08-21,红磡,出境,0,0,0,0
2020-08-21,罗湖,入境,0,0,0,0
2020-08-21,罗湖,出境,0,0,0,0
2020-08-21,落马洲支线,入境,0,0,0,0
2020-08-21,落马洲支线,出境,0,0,0,0
2020-08-21,港珠澳大桥,入境,54,3,89,146
2020-08-21,港珠澳大桥,出境,164,7,5,176
2020-08-21,落马洲,入境,0,0,0,0
2020-08-21,落马洲,出境,0,0,0,0
2020-08-21,文锦渡,入境,0,0,0,0
2020-08-21,文锦渡,出境,0,0,0,0
2020-08-21,沙头角,入境,0,0,0,0
2020-08-21,沙头角,出境,0,0,0,0
2020-08-21,深圳湾,入境,612,56,3,671
2020-08-21,深圳湾,出境,715,75,3,793
2020-08-21,中国客运码头,入境,0,0,0,0
2020-08-21,中国客运码头,出境,0,0,0,0
2020-08-21,港口管制,入境,0,0,0,0
2020-08-21,港口管制,出境,0,0,0,0
2020-08-21,启德邮轮码头,入境,0,0,0,0
2020-08-21,启德邮轮码头,出境,0,0,0,0
2020-08-21,港澳客轮码头,入境,0,0,0,0
2020-08-21,港澳客轮码头,出境,0,0,0,0
2020-08-21,屯门客运码头,入境,0,0,0,0
2020-08-21,屯门客运码头,出境,0,0,0,0
2020-08-22,机场,入境,570,1,12,583
2020-08-22,机场,出境,1530,26,48,1604
2020-08-22,高铁西九龙,入境,0,0,0,0
2020-08-22,高铁西九龙,出境,0,0,0,0
2020-08-22,红磡,入境,0,0,0,0
2020-08-22,红磡,出境,0,0,0,0
2020-08-22,罗湖,入境,0,0,0,0
2020-08-22,罗湖,出境,0,0,0,0
2020-08-22,落马洲支线,入境,0,0,0,0
2020-08-22,落马洲支线,出境,0,0,0,0
2020-08-22,港珠澳大桥,入境,41,4,5,50
2020-08-22,港珠澳大桥,出境,182,5,9,196
2020-08-22,落马洲,入境,0,0,0,0
2020-08-22,落马洲,出境,0,0,0,0
2020-08-22,文锦渡,入境,0,0,0,0
2020-08-22,文锦渡,出境,0,0,0,0
2020-08-22,沙头角,入境,0,0,0,0
2020-08-22,沙头角,出境,0,0,0,0
2020-08-22,深圳湾,入境,502,78,3,583
2020-08-22,深圳湾,出境,801,108,1,910
2020-08-22,中国客运码头,入境,0,0,0,0
2020-08-22,中国客运码头,出境,0,0,0,0
2020-08-22,港口管制,入境,0,0,0,0
2020-08-22,港口管制,出境,0,0,0,0
2020-08-22,启德邮轮码头,入境,0,0,0,0
2020-08-22,启德邮轮码头,出境,0,0,0,0
2020-08-22,港澳客轮码头,入境,0,0,0,0
2020-08-22,港澳客轮码头,出境,0,0,0,0
2020-08-22,屯门客运码头,入境,0,0,0,0
2020-08-22,屯门客运码头,出境,0,0,0,0
2020-08-23,机场,入境,865,10,48,923
2020-08-23,机场,出境,1790,27,60,1877
2020-08-23,高铁西九龙,入境,0,0,0,0
2020-08-23,高铁西九龙,出境,0,0,0,0
2020-08-23,红磡,入境,0,0,0,0
2020-08-23,红磡,出境,0,0,0,0
2020-08-23,罗湖,入境,0,0,0,0
2020-08-23,罗湖,出境,0,0,0,0
2020-08-23,落马洲支线,入境,0,0,0,0
2020-08-23,落马洲支线,出境,0,0,0,0
2020-08-23,港珠澳大桥,入境,52,1,0,53
2020-08-23,港珠澳大桥,出境,117,8,1,126
2020-08-23,落马洲,入境,0,0,0,0
2020-08-23,落马洲,出境,0,0,0,0
2020-08-23,文锦渡,入境,0,0,0,0
2020-08-23,文锦渡,出境,0,0,0,0
2020-08-23,沙头角,入境,0,0,0,0
2020-08-23,沙头角,出境,0,0,0,0
2020-08-23,深圳湾,入境,634,68,8,710
2020-08-23,深圳湾,出境,458,58,3,519
2020-08-23,中国客运码头,入境,0,0,0,0
2020-08-23,中国客运码头,出境,0,0,0,0
2020-08-23,港口管制,入境,0,0,0,0
2020-08-23,港口管制,出境,0,0,0,0
2020-08-23,启德邮轮码头,入境,0,0,0,0
2020-08-23,启德邮轮码头,出境,0,0,0,0
2020-08-23,港澳客轮码头,入境,0,0,0,0
2020-08-23,港澳客轮码头,出境,0,0,0,0
2020-08-23,屯门客运码头,入境,0,0,0,0
2020-08-23,屯门客运码头,出境,0,0,0,0
2020-08-24,机场,入境,611,8,9,628
2020-08-24,机场,出境,1045,22,81,1148
2020-08-24,高铁西九龙,入境,0,0,0,0
2020-08-24,高铁西九龙,出境,0,0,0,0
2020-08-24,红磡,入境,0,0,0,0
2020-08-24,红磡,出境,0,0,0,0
2020-08-24,罗湖,入境,0,0,0,0
2020-08-24,罗湖,出境,0,0,0,0
2020-08-24,落马洲支线,入境,0,0,0,0
2020-08-24,落马洲支线,出境,0,0,0,0
2020-08-24,港珠澳大桥,入境,46,1,2,49
2020-08-24,港珠澳大桥,出境,84,6,8,98
2020-08-24,落马洲,入境,0,0,0,0
2020-08-24,落马洲,出境,0,0,0,0
2020-08-24,文锦渡,入境,0,0,0,0
2020-08-24,文锦渡,出境,0,0,0,0
2020-08-24,沙头角,入境,0,0,0,0
2020-08-24,沙头角,出境,0,0,0,0
2020-08-24,深圳湾,入境,614,47,5,666
2020-08-24,深圳湾,出境,395,48,3,446
2020-08-24,中国客运码头,入境,0,0,0,0
2020-08-24,中国客运码头,出境,0,0,0,0
2020-08-24,港口管制,入境,0,0,0,0
2020-08-24,港口管制,出境,0,0,0,0
2020-08-24,启德邮轮码头,入境,0,0,0,0
2020-08-24,启德邮轮码头,出境,0,0,0,0
2020-08-24,港澳客轮码头,入境,0,0,0,0
2020-08-24,港澳客轮码头,出境,0,0,0,0
2020-08-24,屯门客运码头,入境,0,0,0,0
2020-08-24,屯门客运码头,出境,0,0,0,0
2020-08-25,机场,入境,433,9,10,452
2020-08-25,机场,出境,1498,19,91,1608
2020-08-25,高铁西九龙,入境,0,0,0,0
2020-08-25,高铁西九龙,出境,0,0,0,0
2020-08-25,红磡,入境,0,0,0,0
2020-08-25,红磡,出境,0,0,0,0
2020-08-25,罗湖,入境,0,0,0,0
2020-08-25,罗湖,出境,0,0,0,0
2020-08-25,落马洲支线,入境,0,0,0,0
2020-08-25,落马洲支线,出境,0,0,0,0
2020-08-25,港珠澳大桥,入境,55,4,3,62
2020-08-25,港珠澳大桥,出境,131,7,6,144
2020-08-25,落马洲,入境,0,0,0,0
2020-08-25,落马洲,出境,0,0,0,0
2020-08-25,文锦渡,入境,0,0,0,0
2020-08-25,文锦渡,出境,0,0,0,0
2020-08-25,沙头角,入境,0,0,0,0
2020-08-25,沙头角,出境,0,0,0,0
2020-08-25,深圳湾,入境,588,61,4,653
2020-08-25,深圳湾,出境,610,59,6,675
2020-08-25,中国客运码头,入境,0,0,0,0
2020-08-25,中国客运码头,出境,0,0,0,0
2020-08-25,港口管制,入境,0,0,0,0
2020-08-25,港口管制,出境,0,0,0,0
2020-08-25,启德邮轮码头,入境,0,0,0,0
2020-08-25,启德邮轮码头,出境,0,0,0,0
2020-08-25,港澳客轮码头,入境,0,0,0,0
2020-08-25,港澳客轮码头,出境,0,0,0,0
2020-08-25,屯门客运码头,入境,0,0,0,0
2020-08-25,屯门客运码头,出境,0,0,0,0
2020-08-26,机场,入境,588,2,30,620
2020-08-26,机场,出境,1002,10,56,1068
2020-08-26,高铁西九龙,入境,0,0,0,0
2020-08-26,高铁西九龙,出境,0,0,0,0
2020-08-26,红磡,入境,0,0,0,0
2020-08-26,红磡,出境,0,0,0,0
2020-08-26,罗湖,入境,0,0,0,0
2020-08-26,罗湖,出境,0,0,0,0
2020-08-26,落马洲支线,入境,0,0,0,0
2020-08-26,落马洲支线,出境,0,0,0,0
2020-08-26,香园围,入境,0,0,0,0
2020-08-26,香园围,出境,0,0,0,0
2020-08-26,港珠澳大桥,入境,59,2,3,64
2020-08-26,港珠澳大桥,出境,162,10,2,174
2020-08-26,落马洲,入境,0,0,0,0
2020-08-26,落马洲,出境,0,0,0,0
2020-08-26,文锦渡,入境,0,0,0,0
2020-08-26,文锦渡,出境,0,0,0,0
2020-08-26,沙头角,入境,0,0,0,0
2020-08-26,沙头角,出境,0,0,0,0
2020-08-26,深圳湾,入境,658,61,2,721
2020-08-26,深圳湾,出境,771,84,4,859
2020-08-26,中国客运码头,入境,0,0,0,0
2020-08-26,中国客运码头,出境,0,0,0,0
2020-08-26,港口管制,入境,0,0,0,0
2020-08-26,港口管制,出境,0,0,0,0
2020-08-26,启德邮轮码头,入境,0,0,0,0
2020-08-26,启德邮轮码头,出境,0,0,0,0
2020-08-26,港澳客轮码头,入境,0,0,0,0
2020-08-26,港澳客轮码头,出境,0,0,0,0
2020-08-26,屯门客运码头,入境,0,0,0,0
2020-08-26,屯门客运码头,出境,0,0,0,0
2020-08-27,机场,入境,628,4,13,645
2020-08-27,机场,出境,1292,3,49,1344
2020-08-27,高铁西九龙,入境,0,0,0,0
2020-08-27,高铁西九龙,出境,0,0,0,0
2020-08-27,红磡,入境,0,0,0,0
2020-08-27,红磡,出境,0,0,0,0
2020-08-27,罗湖,入境,0,0,0,0
2020-08-27,罗湖,出境,0,0,0,0
2020-08-27,落马洲支线,入境,0,0,0,0
2020-08-27,落马洲支线,出境,0,0,0,0
2020-08-27,香园围,入境,0,0,0,0
2020-08-27,香园围,出境,0,0,0,0
2020-08-27,港珠澳大桥,入境,67,1,2,70
2020-08-27,港珠澳大桥,出境,125,12,6,143
2020-08-27,落马洲,入境,0,0,0,0
2020-08-27,落马洲,出境,0,0,0,0
2020-08-27,文锦渡,入境,0,0,0,0
2020-08-27,文锦渡,出境,0,0,0,0
2020-08-27,沙头角,入境,0,0,0,0
2020-08-27,沙头角,出境,0,0,0,0
2020-08-27,深圳湾,入境,587,70,4,661
2020-08-27,深圳湾,出境,716,67,3,786
2020-08-27,中国客运码头,入境,0,0,0,0
2020-08-27,中国客运码头,出境,0,0,0,0
2020-08-27,港口管制,入境,0,0,0,0
2020-08-27,港口管制,出境,0,0,0,0
2020-08-27,启德邮轮码头,入境,0,0,0,0
2020-08-27,启德邮轮码头,出境,0,0,0,0
2020-08-27,港澳客轮码头,入境,0,0,0,0
2020-08-27,港澳客轮码头,出境,0,0,0,0
2020-08-27,屯门客运码头,入境,0,0,0,0
2020-08-27,屯门客运码头,出境,0,0,0,0
2020-08-28,机场,入境,795,9,35,839
2020-08-28,机场,出境,1624,13,82,1719
2020-08-28,高铁西九龙,入境,0,0,0,0
2020-08-28,高铁西九龙,出境,0,0,0,0
2020-08-28,红磡,入境,0,0,0,0
2020-08-28,红磡,出境,0,0,0,0
2020-08-28,罗湖,入境,0,0,0,0
2020-08-28,罗湖,出境,0,0,0,0
2020-08-28,落马洲支线,入境,0,0,0,0
2020-08-28,落马洲支线,出境,0,0,0,0
2020-08-28,香园围,入境,0,0,0,0
2020-08-28,香园围,出境,0,0,0,0
2020-08-28,港珠澳大桥,入境,64,1,1,66
2020-08-28,港珠澳大桥,出境,118,4,11,133
2020-08-28,落马洲,入境,0,0,0,0
2020-08-28,落马洲,出境,0,0,0,0
2020-08-28,文锦渡,入境,0,0,0,0
2020-08-28,文锦渡,出境,0,0,0,0
2020-08-28,沙头角,入境,0,0,0,0
2020-08-28,沙头角,出境,0,0,0,0
2020-08-28,深圳湾,入境,867,88,8,963
2020-08-28,深圳湾,出境,562,75,4,641
2020-08-28,中国客运码头,入境,0,0,0,0
2020-08-28,中国客运码头,出境,0,0,0,0
2020-08-28,港口管制,入境,0,0,0,0
2020-08-28,港口管制,出境,0,0,0,0
2020-08-28,启德邮轮码头,入境,0,0,0,0
2020-08-28,启德邮轮码头,出境,0,0,0,0
2020-08-28,港澳客轮码头,入境,0,0,0,0
2020-08-28,港澳客轮码头,出境,0,0,0,0
2020-08-28,屯门客运码头,入境,0,0,0,0
2020-08-28,屯门客运码头,出境,0,0,0,0
2020-08-29,机场,入境,805,4,17,826
2020-08-29,机场,出境,1912,42,224,2178
2020-08-29,高铁西九龙,入境,0,0,0,0
2020-08-29,高铁西九龙,出境,0,0,0,0
2020-08-29,红磡,入境,0,0,0,0
2020-08-29,红磡,出境,0,0,0,0
2020-08-29,罗湖,入境,0,0,0,0
2020-08-29,罗湖,出境,0,0,0,0
2020-08-29,落马洲支线,入境,0,0,0,0
2020-08-29,落马洲支线,出境,0,0,0,0
2020-08-29,香园围,入境,0,0,0,0
2020-08-29,香园围,出境,0,0,0,0
2020-08-29,港珠澳大桥,入境,68,3,13,84
2020-08-29,港珠澳大桥,出境,132,11,9,152
2020-08-29,落马洲,入境,0,0,0,0
2020-08-29,落马洲,出境,0,0,0,0
2020-08-29,文锦渡,入境,0,0,0,0
2020-08-29,文锦渡,出境,0,0,0,0
2020-08-29,沙头角,入境,0,0,0,0
2020-08-29,沙头角,出境,0,0,0,0
2020-08-29,深圳湾,入境,755,95,2,852
2020-08-29,深圳湾,出境,452,53,2,507
2020-08-29,中国客运码头,入境,0,0,0,0
2020-08-29,中国客运码头,出境,0,0,0,0
2020-08-29,港口管制,入境,0,0,0,0
2020-08-29,港口管制,出境,0,0,0,0
2020-08-29,启德邮轮码头,入境,0,0,0,0
2020-08-29,启德邮轮码头,出境,0,0,0,0
2020-08-29,港澳客轮码头,入境,0,0,0,0
2020-08-29,港澳客轮码头,出境,0,0,0,0
2020-08-29,屯门客运码头,入境,0,0,0,0
2020-08-29,屯门客运码头,出境,0,0,0,0
2020-08-30,机场,入境,1031,9,32,1072
2020-08-30,机场,出境,1645,10,57,1712
2020-08-30,高铁西九龙,入境,0,0,0,0
2020-08-30,高铁西九龙,出境,0,0,0,0
2020-08-30,红磡,入境,0,0,0,0
2020-08-30,红磡,出境,0,0,0,0
2020-08-30,罗湖,入境,0,0,0,0
2020-08-30,罗湖,出境,0,0,0,0
2020-08-30,落马洲支线,入境,0,0,0,0
2020-08-30,落马洲支线,出境,0,0,0,0
2020-08-30,香园围,入境,0,0,0,0
2020-08-30,香园围,出境,0,0,0,0
2020-08-30,港珠澳大桥,入境,87,6,4,97
2020-08-30,港珠澳大桥,出境,78,4,5,87
2020-08-30,落马洲,入境,0,0,0,0
2020-08-30,落马洲,出境,0,0,0,0
2020-08-30,文锦渡,入境,0,0,0,0
2020-08-30,文锦渡,出境,0,0,0,0
2020-08-30,沙头角,入境,0,0,0,0
2020-08-30,沙头角,出境,0,0,0,0
2020-08-30,深圳湾,入境,1160,113,1,1274
2020-08-30,深圳湾,出境,377,39,1,417
2020-08-30,中国客运码头,入境,0,0,0,0
2020-08-30,中国客运码头,出境,0,0,0,0
2020-08-30,港口管制,入境,0,0,0,0
2020-08-30,港口管制,出境,0,0,0,0
2020-08-30,启德邮轮码头,入境,0,0,0,0
2020-08-30,启德邮轮码头,出境,0,0,0,0
2020-08-30,港澳客轮码头,入境,0,0,0,0
2020-08-30,港澳客轮码头,出境,0,0,0,0
2020-08-30,屯门客运码头,入境,0,0,0,0
2020-08-30,屯门客运码头,出境,0,0,0,0
2020-08-31,机场,入境,616,2,14,632
2020-08-31,机场,出境,1921,6,40,1967
2020-08-31,高铁西九龙,入境,0,0,0,0
2020-08-31,高铁西九龙,出境,0,0,0,0
2020-08-31,红磡,入境,0,0,0,0
2020-08-31,红磡,出境,0,0,0,0
2020-08-31,罗湖,入境,0,0,0,0
2020-08-31,罗湖,出境,0,0,0,0
2020-08-31,落马洲支线,入境,0,0,0,0
2020-08-31,落马洲支线,出境,0,0,0,0
2020-08-31,香园围,入境,0,0,0,0
2020-08-31,香园围,出境,0,0,0,0
2020-08-31,港珠澳大桥,入境,97,5,4,106
2020-08-31,港珠澳大桥,出境,84,5,2,91
2020-08-31,落马洲,入境,0,0,0,0
2020-08-31,落马洲,出境,0,0,0,0
2020-08-31,文锦渡,入境,0,0,0,0
2020-08-31,文锦渡,出境,0,0,0,0
2020-08-31,沙头角,入境,0,0,0,0
2020-08-31,沙头角,出境,0,0,0,0
2020-08-31,深圳湾,入境,1276,96,2,1374
2020-08-31,深圳湾,出境,417,43,4,464
2020-08-31,中国客运码头,入境,0,0,0,0
2020-08-31,中国客运码头,出境,0,0,0,0
2020-08-31,港口管制,入境,0,0,0,0
2020-08-31,港口管制,出境,0,0,0,0
2020-08-31,启德邮轮码头,入境,0,0,0,0
2020-08-31,启德邮轮码头,出境,0,0,0,0
2020-08-31,港澳客轮码头,入境,0,0,0,0
2020-08-31,港澳客轮码头,出境,0,0,0,0
2020-08-31,屯门客运码头,入境,0,0,0,0
2020-08-31,屯门客运码头,出境,0,0,0,0
2020-09-01,机场,入境,545,4,22,571
2020-09-01,机场,出境,1956,18,57,2031
2020-09-01,高铁西九龙,入境,0,0,0,0
2020-09-01,高铁西九龙,出境,0,0,0,0
2020-09-01,红磡,入境,0,0,0,0
2020-09-01,红磡,出境,0,0,0,0
2020-09-01,罗湖,入境,0,0,0,0
2020-09-01,罗湖,出境,0,0,0,0
2020-09-01,落马洲支线,入境,0,0,0,0
2020-09-01,落马洲支线,出境,0,0,0,0
2020-09-01,香园围,入境,0,0,0,0
2020-09-01,香园围,出境,0,0,0,0
2020-09-01,港珠澳大桥,入境,65,1,1,67
2020-09-01,港珠澳大桥,出境,138,4,7,149
2020-09-01,落马洲,入境,0,0,0,0
2020-09-01,落马洲,出境,0,0,0,0
2020-09-01,文锦渡,入境,0,0,0,0
2020-09-01,文锦渡,出境,0,0,0,0
2020-09-01,沙头角,入境,0,0,0,0
2020-09-01,沙头角,出境,0,0,0,0
2020-09-01,深圳湾,入境,816,72,2,890
2020-09-01,深圳湾,出境,643,73,7,723
2020-09-01,中国客运码头,入境,0,0,0,0
2020-09-01,中国客运码头,出境,0,0,0,0
2020-09-01,港口管制,入境,0,0,0,0
2020-09-01,港口管制,出境,0,0,0,0
2020-09-01,启德邮轮码头,入境,0,0,0,0
2020-09-01,启德邮轮码头,出境,0,0,0,0
2020-09-01,港澳客轮码头,入境,0,0,0,0
2020-09-01,港澳客轮码头,出境,0,0,0,0
2020-09-01,屯门客运码头,入境,0,0,0,0
2020-09-01,屯门客运码头,出境,0,0,0,0
2020-09-02,机场,入境,735,6,37,778
2020-09-02,机场,出境,1647,26,40,1713
2020-09-02,高铁西九龙,入境,0,0,0,0
2020-09-02,高铁西九龙,出境,0,0,0,0
2020-09-02,红磡,入境,0,0,0,0
2020-09-02,红磡,出境,0,0,0,0
2020-09-02,罗湖,入境,0,0,0,0
2020-09-02,罗湖,出境,0,0,0,0
2020-09-02,落马洲支线,入境,0,0,0,0
2020-09-02,落马洲支线,出境,0,0,0,0
2020-09-02,香园围,入境,0,0,0,0
2020-09-02,香园围,出境,0,0,0,0
2020-09-02,港珠澳大桥,入境,57,5,1,63
2020-09-02,港珠澳大桥,出境,140,10,1,151
2020-09-02,落马洲,入境,0,0,0,0
2020-09-02,落马洲,出境,0,0,0,0
2020-09-02,文锦渡,入境,0,0,0,0
2020-09-02,文锦渡,出境,0,0,0,0
2020-09-02,沙头角,入境,0,0,0,0
2020-09-02,沙头角,出境,0,0,0,0
2020-09-02,深圳湾,入境,1012,89,2,1103
2020-09-02,深圳湾,出境,710,82,2,794
2020-09-02,中国客运码头,入境,0,0,0,0
2020-09-02,中国客运码头,出境,0,0,0,0
2020-09-02,港口管制,入境,0,0,0,0
2020-09-02,港口管制,出境,0,0,0,0
2020-09-02,启德邮轮码头,入境,0,0,0,0
2020-09-02,启德邮轮码头,出境,0,0,0,0
2020-09-02,港澳客轮码头,入境,0,0,0,0
2020-09-02,港澳客轮码头,出境,0,0,0,0
2020-09-02,屯门客运码头,入境,0,0,0,0
2020-09-02,屯门客运码头,出境,0,0,0,0
2020-09-03,机场,入境,622,4,15,641
2020-09-03,机场,出境,1466,12,28,1506
2020-09-03,高铁西九龙,入境,0,0,0,0
2020-09-03,高铁西九龙,出境,0,0,0,0
2020-09-03,红磡,入境,0,0,0,0
2020-09-03,红磡,出境,0,0,0,0
2020-09-03,罗湖,入境,0,0,0,0
2020-09-03,罗湖,出境,0,0,0,0
2020-09-03,落马洲支线,入境,0,0,0,0
2020-09-03,落马洲支线,出境,0,0,0,0
2020-09-03,香园围,入境,0,0,0,0
2020-09-03,香园围,出境,0,0,0,0
2020-09-03,港珠澳大桥,入境,84,4,4,92
2020-09-03,港珠澳大桥,出境,141,7,2,150
2020-09-03,落马洲,入境,0,0,0,0
2020-09-03,落马洲,出境,0,0,0,0
2020-09-03,文锦渡,入境,0,0,0,0
2020-09-03,文锦渡,出境,0,0,0,0
2020-09-03,沙头角,入境,0,0,0,0
2020-09-03,沙头角,出境,0,0,0,0
2020-09-03,深圳湾,入境,1032,79,4,1115
2020-09-03,深圳湾,出境,756,86,7,849
2020-09-03,中国客运码头,入境,0,0,0,0
2020-09-03,中国客运码头,出境,0,0,0,0
2020-09-03,港口管制,入境,0,0,0,0
2020-09-03,港口管制,出境,0,0,0,0
2020-09-03,启德邮轮码头,入境,0,0,0,0
2020-09-03,启德邮轮码头,出境,0,0,0,0
2020-09-03,港澳客轮码头,入境,0,0,0,0
2020-09-03,港澳客轮码头,出境,0,0,0,0
2020-09-03,屯门客运码头,入境,0,0,0,0
2020-09-03,屯门客运码头,出境,0,0,0,0
2020-09-04,机场,入境,1231,5,32,1268
2020-09-04,机场,出境,1377,16,41,1434
2020-09-04,高铁西九龙,入境,0,0,0,0
2020-09-04,高铁西九龙,出境,0,0,0,0
2020-09-04,红磡,入境,0,0,0,0
2020-09-04,红磡,出境,0,0,0,0
2020-09-04,罗湖,入境,0,0,0,0
2020-09-04,罗湖,出境,0,0,0,0
2020-09-04,落马洲支线,入境,0,0,0,0
2020-09-04,落马洲支线,出境,0,0,0,0
2020-09-04,香园围,入境,0,0,0,0
2020-09-04,香园围,出境,0,0,0,0
2020-09-04,港珠澳大桥,入境,72,2,6,80
2020-09-04,港珠澳大桥,出境,175,6,9,190
2020-09-04,落马洲,入境,0,0,0,0
2020-09-04,落马洲,出境,0,0,0,0
2020-09-04,文锦渡,入境,0,0,0,0
2020-09-04,文锦渡,出境,0,0,0,0
2020-09-04,沙头角,入境,0,0,0,0
2020-09-04,沙头角,出境,0,0,0,0
2020-09-04,深圳湾,入境,845,114,4,963
2020-09-04,深圳湾,出境,695,80,2,777
2020-09-04,中国客运码头,入境,0,0,0,0
2020-09-04,中国客运码头,出境,0,0,0,0
2020-09-04,港口管制,入境,0,0,0,0
2020-09-04,港口管制,出境,0,0,0,0
2020-09-04,启德邮轮码头,入境,0,0,0,0
2020-09-04,启德邮轮码头,出境,0,0,0,0
2020-09-04,港澳客轮码头,入境,0,0,0,0
2020-09-04,港澳客轮码头,出境,0,0,0,0
2020-09-04,屯门客运码头,入境,0,0,0,0
2020-09-04,屯门客运码头,出境,0,0,0,0
2020-09-05,机场,入境,1046,11,28,1085
2020-09-05,机场,出境,1900,40,70,2010
2020-09-05,高铁西九龙,入境,0,0,0,0
2020-09-05,高铁西九龙,出境,0,0,0,0
2020-09-05,红磡,入境,0,0,0,0
2020-09-05,红磡,出境,0,0,0,0
2020-09-05,罗湖,入境,0,0,0,0
2020-09-05,罗湖,出境,0,0,0,0
2020-09-05,落马洲支线,入境,0,0,0,0
2020-09-05,落马洲支线,出境,0,0,0,0
2020-09-05,香园围,入境,0,0,0,0
2020-09-05,香园围,出境,0,0,0,0
2020-09-05,港珠澳大桥,入境,71,4,6,81
2020-09-05,港珠澳大桥,出境,100,6,6,112
2020-09-05,落马洲,入境,0,0,0,0
2020-09-05,落马洲,出境,0,0,0,0
2020-09-05,文锦渡,入境,0,0,0,0
2020-09-05,文锦渡,出境,0,0,0,0
2020-09-05,沙头角,入境,0,0,0,0
2020-09-05,沙头角,出境,0,0,0,0
2020-09-05,深圳湾,入境,1401,154,5,1560
2020-09-05,深圳湾,出境,550,82,3,635
2020-09-05,中国客运码头,入境,0,0,0,0
2020-09-05,中国客运码头,出境,0,0,0,0
2020-09-05,港口管制,入境,0,0,0,0
2020-09-05,港口管制,出境,0,0,0,0
2020-09-05,启德邮轮码头,入境,0,0,0,0
2020-09-05,启德邮轮码头,出境,0,0,0,0
2020-09-05,港澳客轮码头,入境,0,0,0,0
2020-09-05,港澳客轮码头,出境,0,0,0,0
2020-09-05,屯门客运码头,入境,0,0,0,0
2020-09-05,屯门客运码头,出境,0,0,0,0
2020-09-06,机场,入境,1093,5,51,1149
2020-09-06,机场,出境,1633,31,69,1733
2020-09-06,高铁西九龙,入境,0,0,0,0
2020-09-06,高铁西九龙,出境,0,0,0,0
2020-09-06,红磡,入境,0,0,0,0
2020-09-06,红磡,出境,0,0,0,0
2020-09-06,罗湖,入境,0,0,0,0
2020-09-06,罗湖,出境,0,0,0,0
2020-09-06,落马洲支线,入境,0,0,0,0
2020-09-06,落马洲支线,出境,0,0,0,0
2020-09-06,香园围,入境,0,0,0,0
2020-09-06,香园围,出境,0,0,0,0
2020-09-06,港珠澳大桥,入境,199,10,6,215
2020-09-06,港珠澳大桥,出境,39,3,0,42
2020-09-06,落马洲,入境,0,0,0,0
2020-09-06,落马洲,出境,0,0,0,0
2020-09-06,文锦渡,入境,0,0,0,0
2020-09-06,文锦渡,出境,0,0,0,0
2020-09-06,沙头角,入境,0,0,0,0
2020-09-06,沙头角,出境,0,0,0,0
2020-09-06,深圳湾,入境,2543,257,12,2812
2020-09-06,深圳湾,出境,337,44,2,383
2020-09-06,中国客运码头,入境,0,0,0,0
2020-09-06,中国客运码头,出境,0,0,0,0
2020-09-06,港口管制,入境,0,0,0,0
2020-09-06,港口管制,出境,0,0,0,0
2020-09-06,启德邮轮码头,入境,0,0,0,0
2020-09-06,启德邮轮码头,出境,0,0,0,0
2020-09-06,港澳客轮码头,入境,0,0,0,0
2020-09-06,港澳客轮码头,出境,0,0,0,0
2020-09-06,屯门客运码头,入境,0,0,0,0
2020-09-06,屯门客运码头,出境,0,0,0,0
2020-09-07,机场,入境,614,5,19,638
2020-09-07,机场,出境,1242,5,39,1286
2020-09-07,高铁西九龙,入境,0,0,0,0
2020-09-07,高铁西九龙,出境,0,0,0,0
2020-09-07,红磡,入境,0,0,0,0
2020-09-07,红磡,出境,0,0,0,0
2020-09-07,罗湖,入境,0,0,0,0
2020-09-07,罗湖,出境,0,0,0,0
2020-09-07,落马洲支线,入境,0,0,0,0
2020-09-07,落马洲支线,出境,0,0,0,0
2020-09-07,香园围,入境,0,0,0,0
2020-09-07,香园围,出境,0,0,0,0
2020-09-07,港珠澳大桥,入境,125,8,4,137
2020-09-07,港珠澳大桥,出境,71,3,1,75
2020-09-07,落马洲,入境,0,0,0,0
2020-09-07,落马洲,出境,0,0,0,0
2020-09-07,文锦渡,入境,0,0,0,0
2020-09-07,文锦渡,出境,0,0,0,0
2020-09-07,沙头角,入境,0,0,0,0
2020-09-07,沙头角,出境,0,0,0,0
2020-09-07,深圳湾,入境,1680,170,6,1856
2020-09-07,深圳湾,出境,360,43,2,405
2020-09-07,中国客运码头,入境,0,0,0,0
2020-09-07,中国客运码头,出境,0,0,0,0
2020-09-07,港口管制,入境,0,0,0,0
2020-09-07,港口管制,出境,0,0,0,0
2020-09-07,启德邮轮码头,入境,0,0,0,0
2020-09-07,启德邮轮码头,出境,0,0,0,0
2020-09-07,港澳客轮码头,入境,0,0,0,0
2020-09-07,港澳客轮码头,出境,0,0,0,0
2020-09-07,屯门客运码头,入境,0,0,0,0
2020-09-07,屯门客运码头,出境,0,0,0,0
2020-09-08,机场,入境,1030,9,45,1084
2020-09-08,机场,出境,1378,27,46,1451
2020-09-08,高铁西九龙,入境,0,0,0,0
2020-09-08,高铁西九龙,出境,0,0,0,0
2020-09-08,红磡,入境,0,0,0,0
2020-09-08,红磡,出境,0,0,0,0
2020-09-08,罗湖,入境,0,0,0,0
2020-09-08,罗湖,出境,0,0,0,0
2020-09-08,落马洲支线,入境,0,0,0,0
2020-09-08,落马洲支线,出境,0,0,0,0
2020-09-08,香园围,入境,0,0,0,0
2020-09-08,香园围,出境,0,0,0,0
2020-09-08,港珠澳大桥,入境,167,10,5,182
2020-09-08,港珠澳大桥,出境,114,12,3,129
2020-09-08,落马洲,入境,0,0,0,0
2020-09-08,落马洲,出境,0,0,0,0
2020-09-08,文锦渡,入境,0,0,0,0
2020-09-08,文锦渡,出境,0,0,0,0
2020-09-08,沙头角,入境,0,0,0,0
2020-09-08,沙头角,出境,0,0,0,0
2020-09-08,深圳湾,入境,2340,290,7,2637
2020-09-08,深圳湾,出境,735,64,7,806
2020-09-08,中国客运码头,入境,0,0,0,0
2020-09-08,中国客运码头,出境,0,0,0,0
2020-09-08,港口管制,入境,0,0,0,0
2020-09-08,港口管制,出境,0,0,0,0
2020-09-08,启德邮轮码头,入境,0,0,0,0
2020-09-08,启德邮轮码头,出境,0,0,0,0
2020-09-08,港澳客轮码头,入境,0,0,0,0
2020-09-08,港澳客轮码头,出境,0,0,0,0
2020-09-08,屯门客运码头,入境,0,0,0,0
2020-09-08,屯门客运码头,出境,0,0,0,0
2020-09-09,机场,入境,916,9,24,949
2020-09-09,机场,出境,1181,18,115,1314
2020-09-09,高铁西九龙,入境,0,0,0,0
2020-09-09,高铁西九龙,出境,0,0,0,0
2020-09-09,红磡,入境,0,0,0,0
2020-09-09,红磡,出境,0,0,0,0
2020-09-09,罗湖,入境,0,0,0,0
2020-09-09,罗湖,出境,0,0,0,0
2020-09-09,落马洲支线,入境,0,0,0,0
2020-09-09,落马洲支线,出境,0,0,0,0
2020-09-09,香园围,入境,0,0,0,0
2020-09-09,香园围,出境,0,0,0,0
2020-09-09,港珠澳大桥,入境,137,7,50,194
2020-09-09,港珠澳大桥,出境,113,9,3,125
2020-09-09,落马洲,入境,0,0,0,0
2020-09-09,落马洲,出境,0,0,0,0
2020-09-09,文锦渡,入境,0,0,0,0
2020-09-09,文锦渡,出境,0,0,0,0
2020-09-09,沙头角,入境,0,0,0,0
2020-09-09,沙头角,出境,0,0,0,0
2020-09-09,深圳湾,入境,2182,291,9,2482
2020-09-09,深圳湾,出境,636,96,4,736
2020-09-09,中国客运码头,入境,0,0,0,0
2020-09-09,中国客运码头,出境,0,0,0,0
2020-09-09,港口管制,入境,0,0,0,0
2020-09-09,港口管制,出境,0,0,0,0
2020-09-09,启德邮轮码头,入境,0,0,0,0
2020-09-09,启德邮轮码头,出境,0,0,0,0
2020-09-09,港澳客轮码头,入境,0,0,0,0
2020-09-09,港澳客轮码头,出境,0,0,0,0
2020-09-09,屯门客运码头,入境,0,0,0,0
2020-09-09,屯门客运码头,出境,0,0,0,0
2020-09-10,机场,入境,688,4,15,707
2020-09-10,机场,出境,1199,11,37,1247
2020-09-10,高铁西九龙,入境,0,0,0,0
2020-09-10,高铁西九龙,出境,0,0,0,0
2020-09-10,红磡,入境,0,0,0,0
2020-09-10,红磡,出境,0,0,0,0
2020-09-10,罗湖,入境,0,0,0,0
2020-09-10,罗湖,出境,0,0,0,0
2020-09-10,落马洲支线,入境,0,0,0,0
2020-09-10,落马洲支线,出境,0,0,0,0
2020-09-10,香园围,入境,0,0,0,0
2020-09-10,香园围,出境,0,0,0,0
2020-09-10,港珠澳大桥,入境,125,9,3,137
2020-09-10,港珠澳大桥,出境,136,7,7,150
2020-09-10,落马洲,入境,0,0,0,0
2020-09-10,落马洲,出境,0,0,0,0
2020-09-10,文锦渡,入境,0,0,0,0
2020-09-10,文锦渡,出境,0,0,0,0
2020-09-10,沙头角,入境,0,0,0,0
2020-09-10,沙头角,出境,0,0,0,0
2020-09-10,深圳湾,入境,1317,171,7,1495
2020-09-10,深圳湾,出境,612,84,6,702
2020-09-10,中国客运码头,入境,0,0,0,0
2020-09-10,中国客运码头,出境,0,0,0,0
2020-09-10,港口管制,入境,0,0,0,0
2020-09-10,港口管制,出境,0,0,0,0
2020-09-10,启德邮轮码头,入境,0,0,0,0
2020-09-10,启德邮轮码头,出境,0,0,0,0
2020-09-10,港澳客轮码头,入境,0,0,0,0
2020-09-10,港澳客轮码头,出境,0,0,0,0
2020-09-10,屯门客运码头,入境,0,0,0,0
2020-09-10,屯门客运码头,出境,0,0,0,0
2020-09-11,机场,入境,1166,7,44,1217
2020-09-11,机场,出境,1430,9,56,1495
2020-09-11,高铁西九龙,入境,0,0,0,0
2020-09-11,高铁西九龙,出境,0,0,0,0
2020-09-11,红磡,入境,0,0,0,0
2020-09-11,红磡,出境,0,0,0,0
2020-09-11,罗湖,入境,0,0,0,0
2020-09-11,罗湖,出境,0,0,0,0
2020-09-11,落马洲支线,入境,0,0,0,0
2020-09-11,落马洲支线,出境,0,0,0,0
2020-09-11,香园围,入境,0,0,0,0
2020-09-11,香园围,出境,0,0,0,0
2020-09-11,港珠澳大桥,入境,110,7,7,124
2020-09-11,港珠澳大桥,出境,133,8,2,143
2020-09-11,落马洲,入境,0,0,0,0
2020-09-11,落马洲,出境,0,0,0,0
2020-09-11,文锦渡,入境,0,0,0,0
2020-09-11,文锦渡,出境,0,0,0,0
2020-09-11,沙头角,入境,0,0,0,0
2020-09-11,沙头角,出境,0,0,0,0
2020-09-11,深圳湾,入境,1213,180,6,1399
2020-09-11,深圳湾,出境,537,89,5,631
2020-09-11,中国客运码头,入境,0,0,0,0
2020-09-11,中国客运码头,出境,0,0,0,0
2020-09-11,港口管制,入境,0,0,0,0
2020-09-11,港口管制,出境,0,0,0,0
2020-09-11,启德邮轮码头,入境,0,0,0,0
2020-09-11,启德邮轮码头,出境,0,0,0,0
2020-09-11,港澳客轮码头,入境,0,0,0,0
2020-09-11,港澳客轮码头,出境,0,0,0,0
2020-09-11,屯门客运码头,入境,0,0,0,0
2020-09-11,屯门客运码头,出境,0,0,0,0
2020-09-12,机场,入境,959,15,39,1013
2020-09-12,机场,出境,1457,40,46,1543
2020-09-12,高铁西九龙,入境,0,0,0,0
2020-09-12,高铁西九龙,出境,0,0,0,0
2020-09-12,红磡,入境,0,0,0,0
2020-09-12,红磡,出境,0,0,0,0
2020-09-12,罗湖,入境,0,0,0,0
2020-09-12,罗湖,出境,0,0,0,0
2020-09-12,落马洲支线,入境,0,0,0,0
2020-09-12,落马洲支线,出境,0,0,0,0
2020-09-12,香园围,入境,0,0,0,0
2020-09-12,香园围,出境,0,0,0,0
2020-09-12,港珠澳大桥,入境,109,13,5,127
2020-09-12,港珠澳大桥,出境,101,8,3,112
2020-09-12,落马洲,入境,0,0,0,0
2020-09-12,落马洲,出境,0,0,0,0
2020-09-12,文锦渡,入境,0,0,0,0
2020-09-12,文锦渡,出境,0,0,0,0
2020-09-12,沙头角,入境,0,0,0,0
2020-09-12,沙头角,出境,0,0,0,0
2020-09-12,深圳湾,入境,1576,251,4,1831
2020-09-12,深圳湾,出境,576,88,2,666
2020-09-12,中国客运码头,入境,0,0,0,0
2020-09-12,中国客运码头,出境,0,0,0,0
2020-09-12,港口管制,入境,0,0,0,0
2020-09-12,港口管制,出境,0,0,0,0
2020-09-12,启德邮轮码头,入境,0,0,0,0
2020-09-12,启德邮轮码头,出境,0,0,0,0
2020-09-12,港澳客轮码头,入境,0,0,0,0
2020-09-12,港澳客轮码头,出境,0,0,0,0
2020-09-12,屯门客运码头,入境,0,0,0,0
2020-09-12,屯门客运码头,出境,0,0,0,0
2020-09-13,机场,入境,1351,9,49,1409
2020-09-13,机场,出境,1426,29,60,1515
2020-09-13,高铁西九龙,入境,0,0,0,0
2020-09-13,高铁西九龙,出境,0,0,0,0
2020-09-13,红磡,入境,0,0,0,0
2020-09-13,红磡,出境,0,0,0,0
2020-09-13,罗湖,入境,0,0,0,0
2020-09-13,罗湖,出境,0,0,0,0
2020-09-13,落马洲支线,入境,0,0,0,0
2020-09-13,落马洲支线,出境,0,0,0,0
2020-09-13,香园围,入境,0,0,0,0
2020-09-13,香园围,出境,0,0,0,0
2020-09-13,港珠澳大桥,入境,229,20,7,256
2020-09-13,港珠澳大桥,出境,70,2,4,76
2020-09-13,落马洲,入境,0,0,0,0
2020-09-13,落马洲,出境,0,0,0,0
2020-09-13,文锦渡,入境,0,0,0,0
2020-09-13,文锦渡,出境,0,0,0,0
2020-09-13,沙头角,入境,0,0,0,0
2020-09-13,沙头角,出境,0,0,0,0
2020-09-13,深圳湾,入境,3251,443,9,3703
2020-09-13,深圳湾,出境,416,72,3,491
2020-09-13,中国客运码头,入境,0,0,0,0
2020-09-13,中国客运码头,出境,0,0,0,0
2020-09-13,港口管制,入境,0,0,0,0
2020-09-13,港口管制,出境,0,0,0,0
2020-09-13,启德邮轮码头,入境,0,0,0,0
2020-09-13,启德邮轮码头,出境,0,0,0,0
2020-09-13,港澳客轮码头,入境,0,0,0,0
2020-09-13,港澳客轮码头,出境,0,0,0,0
2020-09-13,屯门客运码头,入境,0,0,0,0
2020-09-13,屯门客运码头,出境,0,0,0,0
2020-09-14,机场,入境,656,4,26,686
2020-09-14,机场,出境,866,8,38,912
2020-09-14,高铁西九龙,入境,0,0,0,0
2020-09-14,高铁西九龙,出境,0,0,0,0
2020-09-14,红磡,入境,0,0,0,0
2020-09-14,红磡,出境,0,0,0,0
2020-09-14,罗湖,入境,0,0,0,0
2020-09-14,罗湖,出境,0,0,0,0
2020-09-14,落马洲支线,入境,0,0,0,0
2020-09-14,落马洲支线,出境,0,0,0,0
2020-09-14,香园围,入境,0,0,0,0
2020-09-14,香园围,出境,0,0,0,0
2020-09-14,港珠澳大桥,入境,160,9,3,172
2020-09-14,港珠澳大桥,出境,87,2,3,92
2020-09-14,落马洲,入境,0,0,0,0
2020-09-14,落马洲,出境,0,0,0,0
2020-09-14,文锦渡,入境,0,0,0,0
2020-09-14,文锦渡,出境,0,0,0,0
2020-09-14,沙头角,入境,0,0,0,0
2020-09-14,沙头角,出境,0,0,0,0
2020-09-14,深圳湾,入境,2277,302,7,2586
2020-09-14,深圳湾,出境,415,45,4,464
2020-09-14,中国客运码头,入境,0,0,0,0
2020-09-14,中国客运码头,出境,0,0,0,0
2020-09-14,港口管制,入境,0,0,0,0
2020-09-14,港口管制,出境,0,0,0,0
2020-09-14,启德邮轮码头,入境,0,0,0,0
2020-09-14,启德邮轮码头,出境,0,0,0,0
2020-09-14,港澳客轮码头,入境,0,0,0,0
2020-09-14,港澳客轮码头,出境,0,0,0,0
2020-09-14,屯门客运码头,入境,0,0,0,0
2020-09-14,屯门客运码头,出境,0,0,0,0
2020-09-15,机场,入境,754,7,40,801
2020-09-15,机场,出境,1340,18,64,1422
2020-09-15,高铁西九龙,入境,0,0,0,0
2020-09-15,高铁西九龙,出境,0,0,0,0
2020-09-15,红磡,入境,0,0,0,0
2020-09-15,红磡,出境,0,0,0,0
2020-09-15,罗湖,入境,0,0,0,0
2020-09-15,罗湖,出境,0,0,0,0
2020-09-15,落马洲支线,入境,0,0,0,0
2020-09-15,落马洲支线,出境,0,0,0,0
2020-09-15,香园围,入境,0,0,0,0
2020-09-15,香园围,出境,0,0,0,0
2020-09-15,港珠澳大桥,入境,125,6,5,136
2020-09-15,港珠澳大桥,出境,128,3,3,134
2020-09-15,落马洲,入境,0,0,0,0
2020-09-15,落马洲,出境,0,0,0,0
2020-09-15,文锦渡,入境,0,0,0,0
2020-09-15,文锦渡,出境,0,0,0,0
2020-09-15,沙头角,入境,0,0,0,0
2020-09-15,沙头角,出境,0,0,0,0
2020-09-15,深圳湾,入境,1764,263,9,2036
2020-09-15,深圳湾,出境,550,51,2,603
2020-09-15,中国客运码头,入境,0,0,0,0
2020-09-15,中国客运码头,出境,0,0,0,0
2020-09-15,港口管制,入境,0,0,0,0
2020-09-15,港口管制,出境,0,0,0,0
2020-09-15,启德邮轮码头,入境,0,0,0,0
2020-09-15,启德邮轮码头,出境,0,0,0,0
2020-09-15,港澳客轮码头,入境,0,0,0,0
2020-09-15,港澳客轮码头,出境,0,0,0,0
2020-09-15,屯门客运码头,入境,0,0,0,0
2020-09-15,屯门客运码头,出境,0,0,0,0
2020-09-16,机场,入境,799,10,30,839
2020-09-16,机场,出境,1065,17,47,1129
2020-09-16,高铁西九龙,入境,0,0,0,0
2020-09-16,高铁西九龙,出境,0,0,0,0
2020-09-16,红磡,入境,0,0,0,0
2020-09-16,红磡,出境,0,0,0,0
2020-09-16,罗湖,入境,0,0,0,0
2020-09-16,罗湖,出境,0,0,0,0
2020-09-16,落马洲支线,入境,0,0,0,0
2020-09-16,落马洲支线,出境,0,0,0,0
2020-09-16,香园围,入境,0,0,0,0
2020-09-16,香园围,出境,0,0,0,0
2020-09-16,港珠澳大桥,入境,73,3,2,78
2020-09-16,港珠澳大桥,出境,321,11,7,339
2020-09-16,落马洲,入境,0,0,0,0
2020-09-16,落马洲,出境,0,0,0,0
2020-09-16,文锦渡,入境,0,0,0,0
2020-09-16,文锦渡,出境,0,0,0,0
2020-09-16,沙头角,入境,0,0,0,0
2020-09-16,沙头角,出境,0,0,0,0
2020-09-16,深圳湾,入境,1091,183,5,1279
2020-09-16,深圳湾,出境,1189,85,5,1279
2020-09-16,中国客运码头,入境,0,0,0,0
2020-09-16,中国客运码头,出境,0,0,0,0
2020-09-16,港口管制,入境,0,0,0,0
2020-09-16,港口管制,出境,0,0,0,0
2020-09-16,启德邮轮码头,入境,0,0,0,0
2020-09-16,启德邮轮码头,出境,0,0,0,0
2020-09-16,港澳客轮码头,入境,0,0,0,0
2020-09-16,港澳客轮码头,出境,0,0,0,0
2020-09-16,屯门客运码头,入境,0,0,0,0
2020-09-16,屯门客运码头,出境,0,0,0,0
2020-09-17,机场,入境,650,5,21,676
2020-09-17,机场,出境,1276,6,42,1324
2020-09-17,高铁西九龙,入境,0,0,0,0
2020-09-17,高铁西九龙,出境,0,0,0,0
2020-09-17,红磡,入境,0,0,0,0
2020-09-17,红磡,出境,0,0,0,0
2020-09-17,罗湖,入境,0,0,0,0
2020-09-17,罗湖,出境,0,0,0,0
2020-09-17,落马洲支线,入境,0,0,0,0
2020-09-17,落马洲支线,出境,0,0,0,0
2020-09-17,香园围,入境,0,0,0,0
2020-09-17,香园围,出境,0,0,0,0
2020-09-17,港珠澳大桥,入境,72,4,1,77
2020-09-17,港珠澳大桥,出境,87,9,4,100
2020-09-17,落马洲,入境,0,0,0,0
2020-09-17,落马洲,出境,0,0,0,0
2020-09-17,文锦渡,入境,0,0,0,0
2020-09-17,文锦渡,出境,0,0,0,0
2020-09-17,沙头角,入境,0,0,0,0
2020-09-17,沙头角,出境,0,0,0,0
2020-09-17,深圳湾,入境,844,103,0,947
2020-09-17,深圳湾,出境,459,37,3,499
2020-09-17,中国客运码头,入境,0,0,0,0
2020-09-17,中国客运码头,出境,0,0,0,0
2020-09-17,港口管制,入境,0,0,0,0
2020-09-17,港口管制,出境,0,0,0,0
2020-09-17,启德邮轮码头,入境,0,0,0,0
2020-09-17,启德邮轮码头,出境,0,0,0,0
2020-09-17,港澳客轮码头,入境,0,0,0,0
2020-09-17,港澳客轮码头,出境,0,0,0,0
2020-09-17,屯门客运码头,入境,0,0,0,0
2020-09-17,屯门客运码头,出境,0,0,0,0
2020-09-18,机场,入境,822,4,41,867
2020-09-18,机场,出境,1336,5,41,1382
2020-09-18,高铁西九龙,入境,0,0,0,0
2020-09-18,高铁西九龙,出境,0,0,0,0
2020-09-18,红磡,入境,0,0,0,0
2020-09-18,红磡,出境,0,0,0,0
2020-09-18,罗湖,入境,0,0,0,0
2020-09-18,罗湖,出境,0,0,0,0
2020-09-18,落马洲支线,入境,0,0,0,0
2020-09-18,落马洲支线,出境,0,0,0,0
2020-09-18,香园围,入境,0,0,0,0
2020-09-18,香园围,出境,0,0,0,0
2020-09-18,港珠澳大桥,入境,75,11,3,89
2020-09-18,港珠澳大桥,出境,72,2,1,75
2020-09-18,落马洲,入境,0,0,0,0
2020-09-18,落马洲,出境,0,0,0,0
2020-09-18,文锦渡,入境,0,0,0,0
2020-09-18,文锦渡,出境,0,0,0,0
2020-09-18,沙头角,入境,0,0,0,0
2020-09-18,沙头角,出境,0,0,0,0
2020-09-18,深圳湾,入境,868,121,4,993
2020-09-18,深圳湾,出境,393,48,11,452
2020-09-18,中国客运码头,入境,0,0,0,0
2020-09-18,中国客运码头,出境,0,0,0,0
2020-09-18,港口管制,入境,0,0,0,0
2020-09-18,港口管制,出境,0,0,0,0
2020-09-18,启德邮轮码头,入境,0,0,0,0
2020-09-18,启德邮轮码头,出境,0,0,0,0
2020-09-18,港澳客轮码头,入境,0,0,0,0
2020-09-18,港澳客轮码头,出境,0,0,0,0
2020-09-18,屯门客运码头,入境,0,0,0,0
2020-09-18,屯门客运码头,出境,0,0,0,0
2020-09-19,机场,入境,1306,11,31,1348
2020-09-19,机场,出境,1544,25,36,1605
2020-09-19,高铁西九龙,入境,0,0,0,0
2020-09-19,高铁西九龙,出境,0,0,0,0
2020-09-19,红磡,入境,0,0,0,0
2020-09-19,红磡,出境,0,0,0,0
2020-09-19,罗湖,入境,0,0,0,0
2020-09-19,罗湖,出境,0,0,0,0
2020-09-19,落马洲支线,入境,0,0,0,0
2020-09-19,落马洲支线,出境,0,0,0,0
2020-09-19,香园围,入境,0,0,0,0
2020-09-19,香园围,出境,0,0,0,0
2020-09-19,港珠澳大桥,入境,114,9,4,127
2020-09-19,港珠澳大桥,出境,82,6,5,93
2020-09-19,落马洲,入境,0,0,0,0
2020-09-19,落马洲,出境,0,0,0,0
2020-09-19,文锦渡,入境,0,0,0,0
2020-09-19,文锦渡,出境,0,0,0,0
2020-09-19,沙头角,入境,0,0,0,0
2020-09-19,沙头角,出境,0,0,0,0
2020-09-19,深圳湾,入境,1236,202,4,1442
2020-09-19,深圳湾,出境,357,52,6,415
2020-09-19,中国客运码头,入境,0,0,0,0
2020-09-19,中国客运码头,出境,0,0,0,0
2020-09-19,港口管制,入境,0,0,0,0
2020-09-19,港口管制,出境,0,0,0,0
2020-09-19,启德邮轮码头,入境,0,0,0,0
2020-09-19,启德邮轮码头,出境,0,0,0,0
2020-09-19,港澳客轮码头,入境,0,0,0,0
2020-09-19,港澳客轮码头,出境,0,0,0,0
2020-09-19,屯门客运码头,入境,0,0,0,0
2020-09-19,屯门客运码头,出境,0,0,0,0
2020-09-20,机场,入境,1171,9,43,1223
2020-09-20,机场,出境,1292,21,48,1361
2020-09-20,高铁西九龙,入境,0,0,0,0
2020-09-20,高铁西九龙,出境,0,0,0,0
2020-09-20,红磡,入境,0,0,0,0
2020-09-20,红磡,出境,0,0,0,0
2020-09-20,罗湖,入境,0,0,0,0
2020-09-20,罗湖,出境,0,0,0,0
2020-09-20,落马洲支线,入境,0,0,0,0
2020-09-20,落马洲支线,出境,0,0,0,0
2020-09-20,香园围,入境,0,0,0,0
2020-09-20,香园围,出境,0,0,0,0
2020-09-20,港珠澳大桥,入境,144,16,5,165
2020-09-20,港珠澳大桥,出境,50,5,1,56
2020-09-20,落马洲,入境,0,0,0,0
2020-09-20,落马洲,出境,0,0,0,0
2020-09-20,文锦渡,入境,0,0,0,0
2020-09-20,文锦渡,出境,0,0,0,0
2020-09-20,沙头角,入境,0,0,0,0
2020-09-20,沙头角,出境,0,0,0,0
2020-09-20,深圳湾,入境,2339,314,9,2662
2020-09-20,深圳湾,出境,313,26,6,345
2020-09-20,中国客运码头,入境,0,0,0,0
2020-09-20,中国客运码头,出境,0,0,0,0
2020-09-20,港口管制,入境,0,0,0,0
2020-09-20,港口管制,出境,0,0,0,0
2020-09-20,启德邮轮码头,入境,0,0,0,0
2020-09-20,启德邮轮码头,出境,0,0,0,0
2020-09-20,港澳客轮码头,入境,0,0,0,0
2020-09-20,港澳客轮码头,出境,0,0,0,0
2020-09-20,屯门客运码头,入境,0,0,0,0
2020-09-20,屯门客运码头,出境,0,0,0,0
2020-09-21,机场,入境,740,1,17,758
2020-09-21,机场,出境,1110,5,23,1138
2020-09-21,高铁西九龙,入境,0,0,0,0
2020-09-21,高铁西九龙,出境,0,0,0,0
2020-09-21,红磡,入境,0,0,0,0
2020-09-21,红磡,出境,0,0,0,0
2020-09-21,罗湖,入境,0,0,0,0
2020-09-21,罗湖,出境,0,0,0,0
2020-09-21,落马洲支线,入境,0,0,0,0
2020-09-21,落马洲支线,出境,0,0,0,0
2020-09-21,香园围,入境,0,0,0,0
2020-09-21,香园围,出境,0,0,0,0
2020-09-21,港珠澳大桥,入境,119,9,1,129
2020-09-21,港珠澳大桥,出境,44,1,3,48
2020-09-21,落马洲,入境,0,0,0,0
2020-09-21,落马洲,出境,0,0,0,0
2020-09-21,文锦渡,入境,0,0,0,0
2020-09-21,文锦渡,出境,0,0,0,0
2020-09-21,沙头角,入境,0,0,0,0
2020-09-21,沙头角,出境,0,0,0,0
2020-09-21,深圳湾,入境,1398,204,3,1605
2020-09-21,深圳湾,出境,296,39,3,338
2020-09-21,中国客运码头,入境,0,0,0,0
2020-09-21,中国客运码头,出境,0,0,0,0
2020-09-21,港口管制,入境,0,0,0,0
2020-09-21,港口管制,出境,0,0,0,0
2020-09-21,启德邮轮码头,入境,0,0,0,0
2020-09-21,启德邮轮码头,出境,0,0,0,0
2020-09-21,港澳客轮码头,入境,0,0,0,0
2020-09-21,港澳客轮码头,出境,0,0,0,0
2020-09-21,屯门客运码头,入境,0,0,0,0
2020-09-21,屯门客运码头,出境,0,0,0,0
2020-09-22,机场,入境,740,2,21,763
2020-09-22,机场,出境,1109,22,57,1188
2020-09-22,高铁西九龙,入境,0,0,0,0
2020-09-22,高铁西九龙,出境,0,0,0,0
2020-09-22,红磡,入境,0,0,0,0
2020-09-22,红磡,出境,0,0,0,0
2020-09-22,罗湖,入境,0,0,0,0
2020-09-22,罗湖,出境,0,0,0,0
2020-09-22,落马洲支线,入境,0,0,0,0
2020-09-22,落马洲支线,出境,0,0,0,0
2020-09-22,香园围,入境,0,0,0,0
2020-09-22,香园围,出境,0,0,0,0
2020-09-22,港珠澳大桥,入境,104,5,2,111
2020-09-22,港珠澳大桥,出境,102,6,1,109
2020-09-22,落马洲,入境,0,0,0,0
2020-09-22,落马洲,出境,0,0,0,0
2020-09-22,文锦渡,入境,0,0,0,0
2020-09-22,文锦渡,出境,0,0,0,0
2020-09-22,沙头角,入境,0,0,0,0
2020-09-22,沙头角,出境,0,0,0,0
2020-09-22,深圳湾,入境,950,129,3,1082
2020-09-22,深圳湾,出境,373,32,7,412
2020-09-22,中国客运码头,入境,0,0,0,0
2020-09-22,中国客运码头,出境,0,0,0,0
2020-09-22,港口管制,入境,0,0,0,0
2020-09-22,港口管制,出境,0,0,0,0
2020-09-22,启德邮轮码头,入境,0,0,0,0
2020-09-22,启德邮轮码头,出境,0,0,0,0
2020-09-22,港澳客轮码头,入境,0,0,0,0
2020-09-22,港澳客轮码头,出境,0,0,0,0
2020-09-22,屯门客运码头,入境,0,0,0,0
2020-09-22,屯门客运码头,出境,0,0,0,0
2020-09-23,机场,入境,884,1,39,924
2020-09-23,机场,出境,891,11,60,962
2020-09-23,高铁西九龙,入境,0,0,0,0
2020-09-23,高铁西九龙,出境,0,0,0,0
2020-09-23,红磡,入境,0,0,0,0
2020-09-23,红磡,出境,0,0,0,0
2020-09-23,罗湖,入境,0,0,0,0
2020-09-23,罗湖,出境,0,0,0,0
2020-09-23,落马洲支线,入境,0,0,0,0
2020-09-23,落马洲支线,出境,0,0,0,0
2020-09-23,香园围,入境,0,0,0,0
2020-09-23,香园围,出境,0,0,0,0
2020-09-23,港珠澳大桥,入境,88,6,4,98
2020-09-23,港珠澳大桥,出境,175,5,1,181
2020-09-23,落马洲,入境,0,0,0,0
2020-09-23,落马洲,出境,0,0,0,0
2020-09-23,文锦渡,入境,0,0,0,0
2020-09-23,文锦渡,出境,0,0,0,0
2020-09-23,沙头角,入境,0,0,0,0
2020-09-23,沙头角,出境,0,0,0,0
2020-09-23,深圳湾,入境,878,141,6,1025
2020-09-23,深圳湾,出境,573,80,8,661
2020-09-23,中国客运码头,入境,0,0,0,0
2020-09-23,中国客运码头,出境,0,0,0,0
2020-09-23,港口管制,入境,0,0,0,0
2020-09-23,港口管制,出境,0,0,0,0
2020-09-23,启德邮轮码头,入境,0,0,0,0
2020-09-23,启德邮轮码头,出境,0,0,0,0
2020-09-23,港澳客轮码头,入境,0,0,0,0
2020-09-23,港澳客轮码头,出境,0,0,0,0
2020-09-23,屯门客运码头,入境,0,0,0,0
2020-09-23,屯门客运码头,出境,0,0,0,0
2020-09-24,机场,入境,604,3,14,621
2020-09-24,机场,出境,1255,6,37,1298
2020-09-24,高铁西九龙,入境,0,0,0,0
2020-09-24,高铁西九龙,出境,0,0,0,0
2020-09-24,红磡,入境,0,0,0,0
2020-09-24,红磡,出境,0,0,0,0
2020-09-24,罗湖,入境,0,0,0,0
2020-09-24,罗湖,出境,0,0,0,0
2020-09-24,落马洲支线,入境,0,0,0,0
2020-09-24,落马洲支线,出境,0,0,0,0
2020-09-24,香园围,入境,0,0,0,0
2020-09-24,香园围,出境,0,0,0,0
2020-09-24,港珠澳大桥,入境,103,6,3,112
2020-09-24,港珠澳大桥,出境,110,4,0,114
2020-09-24,落马洲,入境,0,0,0,0
2020-09-24,落马洲,出境,0,0,0,0
2020-09-24,文锦渡,入境,0,0,0,0
2020-09-24,文锦渡,出境,0,0,0,0
2020-09-24,沙头角,入境,0,0,0,0
2020-09-24,沙头角,出境,0,0,0,0
2020-09-24,深圳湾,入境,769,119,5,893
2020-09-24,深圳湾,出境,495,61,7,563
2020-09-24,中国客运码头,入境,0,0,0,0
2020-09-24,中国客运码头,出境,0,0,0,0
2020-09-24,港口管制,入境,0,0,0,0
2020-09-24,港口管制,出境,0,0,0,0
2020-09-24,启德邮轮码头,入境,0,0,0,0
2020-09-24,启德邮轮码头,出境,0,0,0,0
2020-09-24,港澳客轮码头,入境,0,0,0,0
2020-09-24,港澳客轮码头,出境,0,0,0,0
2020-09-24,屯门客运码头,入境,0,0,0,0
2020-09-24,屯门客运码头,出境,0,0,0,0
2020-09-25,机场,入境,885,3,42,930
2020-09-25,机场,出境,1358,13,51,1422
2020-09-25,高铁西九龙,入境,0,0,0,0
2020-09-25,高铁西九龙,出境,0,0,0,0
2020-09-25,红磡,入境,0,0,0,0
2020-09-25,红磡,出境,0,0,0,0
2020-09-25,罗湖,入境,0,0,0,0
2020-09-25,罗湖,出境,0,0,0,0
2020-09-25,落马洲支线,入境,0,0,0,0
2020-09-25,落马洲支线,出境,0,0,0,0
2020-09-25,香园围,入境,0,0,0,0
2020-09-25,香园围,出境,0,0,0,0
2020-09-25,港珠澳大桥,入境,122,3,1,126
2020-09-25,港珠澳大桥,出境,161,5,0,166
2020-09-25,落马洲,入境,0,0,0,0
2020-09-25,落马洲,出境,0,0,0,0
2020-09-25,文锦渡,入境,0,0,0,0
2020-09-25,文锦渡,出境,0,0,0,0
2020-09-25,沙头角,入境,0,0,0,0
2020-09-25,沙头角,出境,0,0,0,0
2020-09-25,深圳湾,入境,965,129,6,1100
2020-09-25,深圳湾,出境,513,71,5,589
2020-09-25,中国客运码头,入境,0,0,0,0
2020-09-25,中国客运码头,出境,0,0,0,0
2020-09-25,港口管制,入境,0,0,0,0
2020-09-25,港口管制,出境,0,0,0,0
2020-09-25,启德邮轮码头,入境,0,0,0,0
2020-09-25,启德邮轮码头,出境,0,0,0,0
2020-09-25,港澳客轮码头,入境,0,0,0,0
2020-09-25,港澳客轮码头,出境,0,0,0,0
2020-09-25,屯门客运码头,入境,0,0,0,0
2020-09-25,屯门客运码头,出境,0,0,0,0
2020-09-26,机场,入境,1100,18,12,1130
2020-09-26,机场,出境,1382,47,27,1456
2020-09-26,高铁西九龙,入境,0,0,0,0
2020-09-26,高铁西九龙,出境,0,0,0,0
2020-09-26,红磡,入境,0,0,0,0
2020-09-26,红磡,出境,0,0,0,0
2020-09-26,罗湖,入境,0,0,0,0
2020-09-26,罗湖,出境,0,0,0,0
2020-09-26,落马洲支线,入境,0,0,0,0
2020-09-26,落马洲支线,出境,0,0,0,0
2020-09-26,香园围,入境,0,0,0,0
2020-09-26,香园围,出境,0,0,0,0
2020-09-26,港珠澳大桥,入境,87,9,1,97
2020-09-26,港珠澳大桥,出境,83,7,1,91
2020-09-26,落马洲,入境,0,0,0,0
2020-09-26,落马洲,出境,0,0,0,0
2020-09-26,文锦渡,入境,0,0,0,0
2020-09-26,文锦渡,出境,0,0,0,0
2020-09-26,沙头角,入境,0,0,0,0
2020-09-26,沙头角,出境,0,0,0,0
2020-09-26,深圳湾,入境,1003,128,5,1136
2020-09-26,深圳湾,出境,489,80,5,574
2020-09-26,中国客运码头,入境,0,0,0,0
2020-09-26,中国客运码头,出境,0,0,0,0
2020-09-26,港口管制,入境,0,0,0,0
2020-09-26,港口管制,出境,0,0,0,0
2020-09-26,启德邮轮码头,入境,0,0,0,0
2020-09-26,启德邮轮码头,出境,0,0,0,0
2020-09-26,港澳客轮码头,入境,0,0,0,0
2020-09-26,港澳客轮码头,出境,0,0,0,0
2020-09-26,屯门客运码头,入境,0,0,0,0
2020-09-26,屯门客运码头,出境,0,0,0,0
2020-09-27,机场,入境,1315,3,37,1355
2020-09-27,机场,出境,1213,8,52,1273
2020-09-27,高铁西九龙,入境,0,0,0,0
2020-09-27,高铁西九龙,出境,0,0,0,0
2020-09-27,红磡,入境,0,0,0,0
2020-09-27,红磡,出境,0,0,0,0
2020-09-27,罗湖,入境,0,0,0,0
2020-09-27,罗湖,出境,0,0,0,0
2020-09-27,落马洲支线,入境,0,0,0,0
2020-09-27,落马洲支线,出境,0,0,0,0
2020-09-27,香园围,入境,0,0,0,0
2020-09-27,香园围,出境,0,0,0,0
2020-09-27,港珠澳大桥,入境,51,5,2,58
2020-09-27,港珠澳大桥,出境,51,2,0,53
2020-09-27,落马洲,入境,0,0,0,0
2020-09-27,落马洲,出境,0,0,0,0
2020-09-27,文锦渡,入境,0,0,0,0
2020-09-27,文锦渡,出境,0,0,0,0
2020-09-27,沙头角,入境,0,0,0,0
2020-09-27,沙头角,出境,0,0,0,0
2020-09-27,深圳湾,入境,1073,147,4,1224
2020-09-27,深圳湾,出境,308,40,9,357
2020-09-27,中国客运码头,入境,0,0,0,0
2020-09-27,中国客运码头,出境,0,0,0,0
2020-09-27,港口管制,入境,0,0,0,0
2020-09-27,港口管制,出境,0,0,0,0
2020-09-27,启德邮轮码头,入境,0,0,0,0
2020-09-27,启德邮轮码头,出境,0,0,0,0
2020-09-27,港澳客轮码头,入境,0,0,0,0
2020-09-27,港澳客轮码头,出境,0,0,0,0
2020-09-27,屯门客运码头,入境,0,0,0,0
2020-09-27,屯门客运码头,出境,0,0,0,0
2020-09-28,机场,入境,965,4,35,1004
2020-09-28,机场,出境,1019,12,40,1071
2020-09-28,高铁西九龙,入境,0,0,0,0
2020-09-28,高铁西九龙,出境,0,0,0,0
2020-09-28,红磡,入境,0,0,0,0
2020-09-28,红磡,出境,0,0,0,0
2020-09-28,罗湖,入境,0,0,0,0
2020-09-28,罗湖,出境,0,0,0,0
2020-09-28,落马洲支线,入境,0,0,0,0
2020-09-28,落马洲支线,出境,0,0,0,0
2020-09-28,香园围,入境,0,0,0,0
2020-09-28,香园围,出境,0,0,0,0
2020-09-28,港珠澳大桥,入境,52,4,1,57
2020-09-28,港珠澳大桥,出境,49,6,3,58
2020-09-28,落马洲,入境,0,0,0,0
2020-09-28,落马洲,出境,0,0,0,0
2020-09-28,文锦渡,入境,0,0,0,0
2020-09-28,文锦渡,出境,0,0,0,0
2020-09-28,沙头角,入境,0,0,0,0
2020-09-28,沙头角,出境,0,0,0,0
2020-09-28,深圳湾,入境,882,116,5,1003
2020-09-28,深圳湾,出境,426,31,9,466
2020-09-28,中国客运码头,入境,0,0,0,0
2020-09-28,中国客运码头,出境,0,0,0,0
2020-09-28,港口管制,入境,0,0,0,0
2020-09-28,港口管制,出境,0,0,0,0
2020-09-28,启德邮轮码头,入境,0,0,0,0
2020-09-28,启德邮轮码头,出境,0,0,0,0
2020-09-28,港澳客轮码头,入境,0,0,0,0
2020-09-28,港澳客轮码头,出境,0,0,0,0
2020-09-28,屯门客运码头,入境,0,0,0,0
2020-09-28,屯门客运码头,出境,0,0,0,0
2020-09-29,机场,入境,1224,11,30,1265
2020-09-29,机场,出境,1303,20,75,1398
2020-09-29,高铁西九龙,入境,0,0,0,0
2020-09-29,高铁西九龙,出境,0,0,0,0
2020-09-29,红磡,入境,0,0,0,0
2020-09-29,红磡,出境,0,0,0,0
2020-09-29,罗湖,入境,0,0,0,0
2020-09-29,罗湖,出境,0,0,0,0
2020-09-29,落马洲支线,入境,0,0,0,0
2020-09-29,落马洲支线,出境,0,0,0,0
2020-09-29,香园围,入境,0,0,0,0
2020-09-29,香园围,出境,0,0,0,0
2020-09-29,港珠澳大桥,入境,81,6,5,92
2020-09-29,港珠澳大桥,出境,78,3,8,89
2020-09-29,落马洲,入境,0,0,0,0
2020-09-29,落马洲,出境,0,0,0,0
2020-09-29,文锦渡,入境,0,0,0,0
2020-09-29,文锦渡,出境,0,0,0,0
2020-09-29,沙头角,入境,0,0,0,0
2020-09-29,沙头角,出境,0,0,0,0
2020-09-29,深圳湾,入境,1010,124,4,1138
2020-09-29,深圳湾,出境,411,48,4,463
2020-09-29,中国客运码头,入境,0,0,0,0
2020-09-29,中国客运码头,出境,0,0,0,0
2020-09-29,港口管制,入境,0,0,0,0
2020-09-29,港口管制,出境,0,0,0,0
2020-09-29,启德邮轮码头,入境,0,0,0,0
2020-09-29,启德邮轮码头,出境,0,0,0,0
2020-09-29,港澳客轮码头,入境,0,0,0,0
2020-09-29,港澳客轮码头,出境,0,0,0,0
2020-09-29,屯门客运码头,入境,0,0,0,0
2020-09-29,屯门客运码头,出境,0,0,0,0
2020-09-30,机场,入境,1678,3,28,1709
2020-09-30,机场,出境,992,18,49,1059
2020-09-30,高铁西九龙,入境,0,0,0,0
2020-09-30,高铁西九龙,出境,0,0,0,0
2020-09-30,红磡,入境,0,0,0,0
2020-09-30,红磡,出境,0,0,0,0
2020-09-30,罗湖,入境,0,0,0,0
2020-09-30,罗湖,出境,0,0,0,0
2020-09-30,落马洲支线,入境,0,0,0,0
2020-09-30,落马洲支线,出境,0,0,0,0
2020-09-30,香园围,入境,0,0,0,0
2020-09-30,香园围,出境,0,0,0,0
2020-09-30,港珠澳大桥,入境,133,5,8,146
2020-09-30,港珠澳大桥,出境,88,7,2,97
2020-09-30,落马洲,入境,0,0,0,0
2020-09-30,落马洲,出境,0,0,0,0
2020-09-30,文锦渡,入境,0,0,0,0
2020-09-30,文锦渡,出境,0,0,0,0
2020-09-30,沙头角,入境,0,0,0,0
2020-09-30,沙头角,出境,0,0,0,0
2020-09-30,深圳湾,入境,1201,141,6,1348
2020-09-30,深圳湾,出境,667,79,22,768
2020-09-30,中国客运码头,入境,0,0,0,0
2020-09-30,中国客运码头,出境,0,0,0,0
2020-09-30,港口管制,入境,0,0,0,0
2020-09-30,港口管制,出境,0,0,0,0
2020-09-30,启德邮轮码头,入境,0,0,0,0
2020-09-30,启德邮轮码头,出境,0,0,0,0
2020-09-30,港澳客轮码头,入境,0,0,0,0
2020-09-30,港澳客轮码头,出境,0,0,0,0
2020-09-30,屯门客运码头,入境,0,0,0,0
2020-09-30,屯门客运码头,出境,0,0,0,0
2020-10-01,机场,入境,898,4,34,936
2020-10-01,机场,出境,1147,5,101,1253
2020-10-01,高铁西九龙,入境,0,0,0,0
2020-10-01,高铁西九龙,出境,0,0,0,0
2020-10-01,红磡,入境,0,0,0,0
2020-10-01,红磡,出境,0,0,0,0
2020-10-01,罗湖,入境,0,0,0,0
2020-10-01,罗湖,出境,0,0,0,0
2020-10-01,落马洲支线,入境,0,0,0,0
2020-10-01,落马洲支线,出境,0,0,0,0
2020-10-01,香园围,入境,0,0,0,0
2020-10-01,香园围,出境,0,0,0,0
2020-10-01,港珠澳大桥,入境,58,4,76,138
2020-10-01,港珠澳大桥,出境,80,10,2,92
2020-10-01,落马洲,入境,0,0,0,0
2020-10-01,落马洲,出境,0,0,0,0
2020-10-01,文锦渡,入境,0,0,0,0
2020-10-01,文锦渡,出境,0,0,0,0
2020-10-01,沙头角,入境,0,0,0,0
2020-10-01,沙头角,出境,0,0,0,0
2020-10-01,深圳湾,入境,570,85,8,663
2020-10-01,深圳湾,出境,403,46,3,452
2020-10-01,中国客运码头,入境,0,0,0,0
2020-10-01,中国客运码头,出境,0,0,0,0
2020-10-01,港口管制,入境,0,0,0,0
2020-10-01,港口管制,出境,0,0,0,0
2020-10-01,启德邮轮码头,入境,0,0,0,0
2020-10-01,启德邮轮码头,出境,0,0,0,0
2020-10-01,港澳客轮码头,入境,0,0,0,0
2020-10-01,港澳客轮码头,出境,0,0,0,0
2020-10-01,屯门客运码头,入境,0,0,0,0
2020-10-01,屯门客运码头,出境,0,0,0,0
2020-10-02,机场,入境,677,4,43,724
2020-10-02,机场,出境,960,19,66,1045
2020-10-02,高铁西九龙,入境,0,0,0,0
2020-10-02,高铁西九龙,出境,0,0,0,0
2020-10-02,红磡,入境,0,0,0,0
2020-10-02,红磡,出境,0,0,0,0
2020-10-02,罗湖,入境,0,0,0,0
2020-10-02,罗湖,出境,0,0,0,0
2020-10-02,落马洲支线,入境,0,0,0,0
2020-10-02,落马洲支线,出境,0,0,0,0
2020-10-02,香园围,入境,0,0,0,0
2020-10-02,香园围,出境,0,0,0,0
2020-10-02,港珠澳大桥,入境,54,0,5,59
2020-10-02,港珠澳大桥,出境,48,3,1,52
2020-10-02,落马洲,入境,0,0,0,0
2020-10-02,落马洲,出境,0,0,0,0
2020-10-02,文锦渡,入境,0,0,0,0
2020-10-02,文锦渡,出境,0,0,0,0
2020-10-02,沙头角,入境,0,0,0,0
2020-10-02,沙头角,出境,0,0,0,0
2020-10-02,深圳湾,入境,946,150,2,1098
2020-10-02,深圳湾,出境,388,60,6,454
2020-10-02,中国客运码头,入境,0,0,0,0
2020-10-02,中国客运码头,出境,0,0,0,0
2020-10-02,港口管制,入境,0,0,0,0
2020-10-02,港口管制,出境,0,0,0,0
2020-10-02,启德邮轮码头,入境,0,0,0,0
2020-10-02,启德邮轮码头,出境,0,0,0,0
2020-10-02,港澳客轮码头,入境,0,0,0,0
2020-10-02,港澳客轮码头,出境,0,0,0,0
2020-10-02,屯门客运码头,入境,0,0,0,0
2020-10-02,屯门客运码头,出境,0,0,0,0
2020-10-03,机场,入境,760,4,19,783
2020-10-03,机场,出境,1051,21,58,1130
2020-10-03,高铁西九龙,入境,0,0,0,0
2020-10-03,高铁西九龙,出境,0,0,0,0
2020-10-03,红磡,入境,0,0,0,0
2020-10-03,红磡,出境,0,0,0,0
2020-10-03,罗湖,入境,0,0,0,0
2020-10-03,罗湖,出境,0,0,0,0
2020-10-03,落马洲支线,入境,0,0,0,0
2020-10-03,落马洲支线,出境,0,0,0,0
2020-10-03,香园围,入境,0,0,0,0
2020-10-03,香园围,出境,0,0,0,0
2020-10-03,港珠澳大桥,入境,54,12,5,71
2020-10-03,港珠澳大桥,出境,35,2,2,39
2020-10-03,落马洲,入境,0,0,0,0
2020-10-03,落马洲,出境,0,0,0,0
2020-10-03,文锦渡,入境,0,0,0,0
2020-10-03,文锦渡,出境,0,0,0,0
2020-10-03,沙头角,入境,0,0,0,0
2020-10-03,沙头角,出境,0,0,0,0
2020-10-03,深圳湾,入境,937,170,6,1113
2020-10-03,深圳湾,出境,182,31,3,216
2020-10-03,中国客运码头,入境,0,0,0,0
2020-10-03,中国客运码头,出境,0,0,0,0
2020-10-03,港口管制,入境,0,0,0,0
2020-10-03,港口管制,出境,0,0,0,0
2020-10-03,启德邮轮码头,入境,0,0,0,0
2020-10-03,启德邮轮码头,出境,0,0,0,0
2020-10-03,港澳客轮码头,入境,0,0,0,0
2020-10-03,港澳客轮码头,出境,0,0,0,0
2020-10-03,屯门客运码头,入境,0,0,0,0
2020-10-03,屯门客运码头,出境,0,0,0,0
2020-10-04,机场,入境,1030,3,59,1092
2020-10-04,机场,出境,846,8,44,898
2020-10-04,高铁西九龙,入境,0,0,0,0
2020-10-04,高铁西九龙,出境,0,0,0,0
2020-10-04,红磡,入境,0,0,0,0
2020-10-04,红磡,出境,0,0,0,0
2020-10-04,罗湖,入境,0,0,0,0
2020-10-04,罗湖,出境,0,0,0,0
2020-10-04,落马洲支线,入境,0,0,0,0
2020-10-04,落马洲支线,出境,0,0,0,0
2020-10-04,香园围,入境,0,0,0,0
2020-10-04,香园围,出境,0,0,0,0
2020-10-04,港珠澳大桥,入境,77,10,4,91
2020-10-04,港珠澳大桥,出境,60,5,3,68
2020-10-04,落马洲,入境,0,0,0,0
2020-10-04,落马洲,出境,0,0,0,0
2020-10-04,文锦渡,入境,0,0,0,0
2020-10-04,文锦渡,出境,0,0,0,0
2020-10-04,沙头角,入境,0,0,0,0
2020-10-04,沙头角,出境,0,0,0,0
2020-10-04,深圳湾,入境,1290,212,9,1511
2020-10-04,深圳湾,出境,320,49,9,378
2020-10-04,中国客运码头,入境,0,0,0,0
2020-10-04,中国客运码头,出境,0,0,0,0
2020-10-04,港口管制,入境,0,0,0,0
2020-10-04,港口管制,出境,0,0,0,0
2020-10-04,启德邮轮码头,入境,0,0,0,0
2020-10-04,启德邮轮码头,出境,0,0,0,0
2020-10-04,港澳客轮码头,入境,0,0,0,0
2020-10-04,港澳客轮码头,出境,0,0,0,0
2020-10-04,屯门客运码头,入境,0,0,0,0
2020-10-04,屯门客运码头,出境,0,0,0,0
2020-10-05,机场,入境,731,2,33,766
2020-10-05,机场,出境,717,13,34,764
2020-10-05,高铁西九龙,入境,0,0,0,0
2020-10-05,高铁西九龙,出境,0,0,0,0
2020-10-05,红磡,入境,0,0,0,0
2020-10-05,红磡,出境,0,0,0,0
2020-10-05,罗湖,入境,0,0,0,0
2020-10-05,罗湖,出境,0,0,0,0
2020-10-05,落马洲支线,入境,0,0,0,0
2020-10-05,落马洲支线,出境,0,0,0,0
2020-10-05,香园围,入境,0,0,0,0
2020-10-05,香园围,出境,0,0,0,0
2020-10-05,港珠澳大桥,入境,78,4,4,86
2020-10-05,港珠澳大桥,出境,98,14,5,117
2020-10-05,落马洲,入境,0,0,0,0
2020-10-05,落马洲,出境,0,0,0,0
2020-10-05,文锦渡,入境,0,0,0,0
2020-10-05,文锦渡,出境,0,0,0,0
2020-10-05,沙头角,入境,0,0,0,0
2020-10-05,沙头角,出境,0,0,0,0
2020-10-05,深圳湾,入境,927,137,2,1066
2020-10-05,深圳湾,出境,450,77,6,533
2020-10-05,中国客运码头,入境,0,0,0,0
2020-10-05,中国客运码头,出境,0,0,0,0
2020-10-05,港口管制,入境,0,0,0,0
2020-10-05,港口管制,出境,0,0,0,0
2020-10-05,启德邮轮码头,入境,0,0,0,0
2020-10-05,启德邮轮码头,出境,0,0,0,0
2020-10-05,港澳客轮码头,入境,0,0,0,0
2020-10-05,港澳客轮码头,出境,0,0,0,0
2020-10-05,屯门客运码头,入境,0,0,0,0
2020-10-05,屯门客运码头,出境,0,0,0,0
2020-10-06,机场,入境,701,4,24,729
2020-10-06,机场,出境,823,23,29,875
2020-10-06,高铁西九龙,入境,0,0,0,0
2020-10-06,高铁西九龙,出境,0,0,0,0
2020-10-06,红磡,入境,0,0,0,0
2020-10-06,红磡,出境,0,0,0,0
2020-10-06,罗湖,入境,0,0,0,0
2020-10-06,罗湖,出境,0,0,0,0
2020-10-06,落马洲支线,入境,0,0,0,0
2020-10-06,落马洲支线,出境,0,0,0,0
2020-10-06,香园围,入境,0,0,0,0
2020-10-06,香园围,出境,0,0,0,0
2020-10-06,港珠澳大桥,入境,66,3,1,70
2020-10-06,港珠澳大桥,出境,160,7,0,167
2020-10-06,落马洲,入境,0,0,0,0
2020-10-06,落马洲,出境,0,0,0,0
2020-10-06,文锦渡,入境,0,0,0,0
2020-10-06,文锦渡,出境,0,0,0,0
2020-10-06,沙头角,入境,0,0,0,0
2020-10-06,沙头角,出境,0,0,0,0
2020-10-06,深圳湾,入境,821,86,5,912
2020-10-06,深圳湾,出境,733,86,6,825
2020-10-06,中国客运码头,入境,0,0,0,0
2020-10-06,中国客运码头,出境,0,0,0,0
2020-10-06,港口管制,入境,0,0,0,0
2020-10-06,港口管制,出境,0,0,0,0
2020-10-06,启德邮轮码头,入境,0,0,0,0
2020-10-06,启德邮轮码头,出境,0,0,0,0
2020-10-06,港澳客轮码头,入境,0,0,0,0
2020-10-06,港澳客轮码头,出境,0,0,0,0
2020-10-06,屯门客运码头,入境,0,0,0,0
2020-10-06,屯门客运码头,出境,0,0,0,0
2020-10-07,机场,入境,525,1,26,552
2020-10-07,机场,出境,621,11,38,670
2020-10-07,高铁西九龙,入境,0,0,0,0
2020-10-07,高铁西九龙,出境,0,0,0,0
2020-10-07,红磡,入境,0,0,0,0
2020-10-07,红磡,出境,0,0,0,0
2020-10-07,罗湖,入境,0,0,0,0
2020-10-07,罗湖,出境,0,0,0,0
2020-10-07,落马洲支线,入境,0,0,0,0
2020-10-07,落马洲支线,出境,0,0,0,0
2020-10-07,香园围,入境,0,0,0,0
2020-10-07,香园围,出境,0,0,0,0
2020-10-07,港珠澳大桥,入境,74,7,6,87
2020-10-07,港珠澳大桥,出境,158,5,4,167
2020-10-07,落马洲,入境,0,0,0,0
2020-10-07,落马洲,出境,0,0,0,0
2020-10-07,文锦渡,入境,0,0,0,0
2020-10-07,文锦渡,出境,0,0,0,0
2020-10-07,沙头角,入境,0,0,0,0
2020-10-07,沙头角,出境,0,0,0,0
2020-10-07,深圳湾,入境,602,77,3,682
2020-10-07,深圳湾,出境,998,171,7,1176
2020-10-07,中国客运码头,入境,0,0,0,0
2020-10-07,中国客运码头,出境,0,0,0,0
2020-10-07,港口管制,入境,0,0,0,0
2020-10-07,港口管制,出境,0,0,0,0
2020-10-07,启德邮轮码头,入境,0,0,0,0
2020-10-07,启德邮轮码头,出境,0,0,0,0
2020-10-07,港澳客轮码头,入境,0,0,0,0
2020-10-07,港澳客轮码头,出境,0,0,0,0
2020-10-07,屯门客运码头,入境,0,0,0,0
2020-10-07,屯门客运码头,出境,0,0,0,0
2020-10-08,机场,入境,798,1,35,834
2020-10-08,机场,出境,932,6,53,991
2020-10-08,高铁西九龙,入境,0,0,0,0
2020-10-08,高铁西九龙,出境,0,0,0,0
2020-10-08,红磡,入境,0,0,0,0
2020-10-08,红磡,出境,0,0,0,0
2020-10-08,罗湖,入境,0,0,0,0
2020-10-08,罗湖,出境,0,0,0,0
2020-10-08,落马洲支线,入境,0,0,0,0
2020-10-08,落马洲支线,出境,0,0,0,0
2020-10-08,香园围,入境,0,0,0,0
2020-10-08,香园围,出境,0,0,0,0
2020-10-08,港珠澳大桥,入境,76,2,2,80
2020-10-08,港珠澳大桥,出境,165,14,2,181
2020-10-08,落马洲,入境,0,0,0,0
2020-10-08,落马洲,出境,0,0,0,0
2020-10-08,文锦渡,入境,0,0,0,0
2020-10-08,文锦渡,出境,0,0,0,0
2020-10-08,沙头角,入境,0,0,0,0
2020-10-08,沙头角,出境,0,0,0,0
2020-10-08,深圳湾,入境,701,73,2,776
2020-10-08,深圳湾,出境,931,112,5,1048
2020-10-08,中国客运码头,入境,0,0,0,0
2020-10-08,中国客运码头,出境,0,0,0,0
2020-10-08,港口管制,入境,0,0,0,0
2020-10-08,港口管制,出境,0,0,0,0
2020-10-08,启德邮轮码头,入境,0,0,0,0
2020-10-08,启德邮轮码头,出境,0,0,0,0
2020-10-08,港澳客轮码头,入境,0,0,0,0
2020-10-08,港澳客轮码头,出境,0,0,0,0
2020-10-08,屯门客运码头,入境,0,0,0,0
2020-10-08,屯门客运码头,出境,0,0,0,0
2020-10-09,机场,入境,793,5,37,835
2020-10-09,机场,出境,790,45,26,861
2020-10-09,高铁西九龙,入境,0,0,0,0
2020-10-09,高铁西九龙,出境,0,0,0,0
2020-10-09,红磡,入境,0,0,0,0
2020-10-09,红磡,出境,0,0,0,0
2020-10-09,罗湖,入境,0,0,0,0
2020-10-09,罗湖,出境,0,0,0,0
2020-10-09,落马洲支线,入境,0,0,0,0
2020-10-09,落马洲支线,出境,0,0,0,0
2020-10-09,香园围,入境,0,0,0,0
2020-10-09,香园围,出境,0,0,0,0
2020-10-09,港珠澳大桥,入境,69,0,7,76
2020-10-09,港珠澳大桥,出境,142,11,9,162
2020-10-09,落马洲,入境,0,0,0,0
2020-10-09,落马洲,出境,0,0,0,0
2020-10-09,文锦渡,入境,0,0,0,0
2020-10-09,文锦渡,出境,0,0,0,0
2020-10-09,沙头角,入境,0,0,0,0
2020-10-09,沙头角,出境,0,0,0,0
2020-10-09,深圳湾,入境,811,99,1,911
2020-10-09,深圳湾,出境,767,104,11,882
2020-10-09,中国客运码头,入境,0,0,0,0
2020-10-09,中国客运码头,出境,0,0,0,0
2020-10-09,港口管制,入境,0,0,0,0
2020-10-09,港口管制,出境,0,0,0,0
2020-10-09,启德邮轮码头,入境,0,0,0,0
2020-10-09,启德邮轮码头,出境,0,0,0,0
2020-10-09,港澳客轮码头,入境,0,0,0,0
2020-10-09,港澳客轮码头,出境,0,0,0,0
2020-10-09,屯门客运码头,入境,0,0,0,0
2020-10-09,屯门客运码头,出境,0,0,0,0
2020-10-10,机场,入境,670,4,14,688
2020-10-10,机场,出境,1028,30,26,1084
2020-10-10,高铁西九龙,入境,0,0,0,0
2020-10-10,高铁西九龙,出境,0,0,0,0
2020-10-10,红磡,入境,0,0,0,0
2020-10-10,红磡,出境,0,0,0,0
2020-10-10,罗湖,入境,0,0,0,0
2020-10-10,罗湖,出境,0,0,0,0
2020-10-10,落马洲支线,入境,0,0,0,0
2020-10-10,落马洲支线,出境,0,0,0,0
2020-10-10,香园围,入境,0,0,0,0
2020-10-10,香园围,出境,0,0,0,0
2020-10-10,港珠澳大桥,入境,84,7,4,95
2020-10-10,港珠澳大桥,出境,110,12,2,124
2020-10-10,落马洲,入境,0,0,0,0
2020-10-10,落马洲,出境,0,0,0,0
2020-10-10,文锦渡,入境,0,0,0,0
2020-10-10,文锦渡,出境,0,0,0,0
2020-10-10,沙头角,入境,0,0,0,0
2020-10-10,沙头角,出境,0,0,0,0
2020-10-10,深圳湾,入境,1212,174,2,1388
2020-10-10,深圳湾,出境,830,125,9,964
2020-10-10,中国客运码头,入境,0,0,0,0
2020-10-10,中国客运码头,出境,0,0,0,0
2020-10-10,港口管制,入境,0,0,0,0
2020-10-10,港口管制,出境,0,0,0,0
2020-10-10,启德邮轮码头,入境,0,0,0,0
2020-10-10,启德邮轮码头,出境,0,0,0,0
2020-10-10,港澳客轮码头,入境,0,0,0,0
2020-10-10,港澳客轮码头,出境,0,0,0,0
2020-10-10,屯门客运码头,入境,0,0,0,0
2020-10-10,屯门客运码头,出境,0,0,0,0
2020-10-11,机场,入境,1304,13,68,1385
2020-10-11,机场,出境,940,48,48,1036
2020-10-11,高铁西九龙,入境,0,0,0,0
2020-10-11,高铁西九龙,出境,0,0,0,0
2020-10-11,红磡,入境,0,0,0,0
2020-10-11,红磡,出境,0,0,0,0
2020-10-11,罗湖,入境,0,0,0,0
2020-10-11,罗湖,出境,0,0,0,0
2020-10-11,落马洲支线,入境,0,0,0,0
2020-10-11,落马洲支线,出境,0,0,0,0
2020-10-11,香园围,入境,0,0,0,0
2020-10-11,香园围,出境,0,0,0,0
2020-10-11,港珠澳大桥,入境,82,8,3,93
2020-10-11,港珠澳大桥,出境,70,10,0,80
2020-10-11,落马洲,入境,0,0,0,0
2020-10-11,落马洲,出境,0,0,0,0
2020-10-11,文锦渡,入境,0,0,0,0
2020-10-11,文锦渡,出境,0,0,0,0
2020-10-11,沙头角,入境,0,0,0,0
2020-10-11,沙头角,出境,0,0,0,0
2020-10-11,深圳湾,入境,1370,157,3,1530
2020-10-11,深圳湾,出境,430,106,5,541
2020-10-11,中国客运码头,入境,0,0,0,0
2020-10-11,中国客运码头,出境,0,0,0,0
2020-10-11,港口管制,入境,0,0,0,0
2020-10-11,港口管制,出境,0,0,0,0
2020-10-11,启德邮轮码头,入境,0,0,0,0
2020-10-11,启德邮轮码头,出境,0,0,0,0
2020-10-11,港澳客轮码头,入境,0,0,0,0
2020-10-11,港澳客轮码头,出境,0,0,0,0
2020-10-11,屯门客运码头,入境,0,0,0,0
2020-10-11,屯门客运码头,出境,0,0,0,0
2020-10-12,机场,入境,478,10,32,520
2020-10-12,机场,出境,545,11,40,596
2020-10-12,高铁西九龙,入境,0,0,0,0
2020-10-12,高铁西九龙,出境,0,0,0,0
2020-10-12,红磡,入境,0,0,0,0
2020-10-12,红磡,出境,0,0,0,0
2020-10-12,罗湖,入境,0,0,0,0
2020-10-12,罗湖,出境,0,0,0,0
2020-10-12,落马洲支线,入境,0,0,0,0
2020-10-12,落马洲支线,出境,0,0,0,0
2020-10-12,香园围,入境,0,0,0,0
2020-10-12,香园围,出境,0,0,0,0
2020-10-12,港珠澳大桥,入境,61,6,2,69
2020-10-12,港珠澳大桥,出境,103,6,1,110
2020-10-12,落马洲,入境,0,0,0,0
2020-10-12,落马洲,出境,0,0,0,0
2020-10-12,文锦渡,入境,0,0,0,0
2020-10-12,文锦渡,出境,0,0,0,0
2020-10-12,沙头角,入境,0,0,0,0
2020-10-12,沙头角,出境,0,0,0,0
2020-10-12,深圳湾,入境,1169,133,5,1307
2020-10-12,深圳湾,出境,643,73,5,721
2020-10-12,中国客运码头,入境,0,0,0,0
2020-10-12,中国客运码头,出境,0,0,0,0
2020-10-12,港口管制,入境,0,0,0,0
2020-10-12,港口管制,出境,0,0,0,0
2020-10-12,启德邮轮码头,入境,0,0,0,0
2020-10-12,启德邮轮码头,出境,0,0,0,0
2020-10-12,港澳客轮码头,入境,0,0,0,0
2020-10-12,港澳客轮码头,出境,0,0,0,0
2020-10-12,屯门客运码头,入境,0,0,0,0
2020-10-12,屯门客运码头,出境,0,0,0,0
2020-10-13,机场,入境,422,2,31,455
2020-10-13,机场,出境,639,22,27,688
2020-10-13,高铁西九龙,入境,0,0,0,0
2020-10-13,高铁西九龙,出境,0,0,0,0
2020-10-13,红磡,入境,0,0,0,0
2020-10-13,红磡,出境,0,0,0,0
2020-10-13,罗湖,入境,0,0,0,0
2020-10-13,罗湖,出境,0,0,0,0
2020-10-13,落马洲支线,入境,0,0,0,0
2020-10-13,落马洲支线,出境,0,0,0,0
2020-10-13,香园围,入境,0,0,0,0
2020-10-13,香园围,出境,0,0,0,0
2020-10-13,港珠澳大桥,入境,0,0,0,0
2020-10-13,港珠澳大桥,出境,0,0,0,0
2020-10-13,落马洲,入境,0,0,0,0
2020-10-13,落马洲,出境,0,0,0,0
2020-10-13,文锦渡,入境,0,0,0,0
2020-10-13,文锦渡,出境,0,0,0,0
2020-10-13,沙头角,入境,0,0,0,0
2020-10-13,沙头角,出境,0,0,0,0
2020-10-13,深圳湾,入境,691,88,2,781
2020-10-13,深圳湾,出境,427,32,4,463
2020-10-13,中国客运码头,入境,0,0,0,0
2020-10-13,中国客运码头,出境,0,0,0,0
2020-10-13,港口管制,入境,0,0,0,0
2020-10-13,港口管制,出境,0,0,0,0
2020-10-13,启德邮轮码头,入境,0,0,0,0
2020-10-13,启德邮轮码头,出境,0,0,0,0
2020-10-13,港澳客轮码头,入境,0,0,0,0
2020-10-13,港澳客轮码头,出境,0,0,0,0
2020-10-13,屯门客运码头,入境,0,0,0,0
2020-10-13,屯门客运码头,出境,0,0,0,0
2020-10-14,机场,入境,564,4,30,598
2020-10-14,机场,出境,656,21,31,708
2020-10-14,高铁西九龙,入境,0,0,0,0
2020-10-14,高铁西九龙,出境,0,0,0,0
2020-10-14,红磡,入境,0,0,0,0
2020-10-14,红磡,出境,0,0,0,0
2020-10-14,罗湖,入境,0,0,0,0
2020-10-14,罗湖,出境,0,0,0,0
2020-10-14,落马洲支线,入境,0,0,0,0
2020-10-14,落马洲支线,出境,0,0,0,0
2020-10-14,香园围,入境,0,0,0,0
2020-10-14,香园围,出境,0,0,0,0
2020-10-14,港珠澳大桥,入境,104,10,5,119
2020-10-14,港珠澳大桥,出境,134,8,2,144
2020-10-14,落马洲,入境,0,0,0,0
2020-10-14,落马洲,出境,0,0,0,0
2020-10-14,文锦渡,入境,0,0,0,0
2020-10-14,文锦渡,出境,0,0,0,0
2020-10-14,沙头角,入境,0,0,0,0
2020-10-14,沙头角,出境,0,0,0,0
2020-10-14,深圳湾,入境,1046,138,2,1186
2020-10-14,深圳湾,出境,843,121,16,980
2020-10-14,中国客运码头,入境,0,0,0,0
2020-10-14,中国客运码头,出境,0,0,0,0
2020-10-14,港口管制,入境,0,0,0,0
2020-10-14,港口管制,出境,0,0,0,0
2020-10-14,启德邮轮码头,入境,0,0,0,0
2020-10-14,启德邮轮码头,出境,0,0,0,0
2020-10-14,港澳客轮码头,入境,0,0,0,0
2020-10-14,港澳客轮码头,出境,0,0,0,0
2020-10-14,屯门客运码头,入境,0,0,0,0
2020-10-14,屯门客运码头,出境,0,0,0,0
2020-10-15,机场,入境,984,3,53,1040
2020-10-15,机场,出境,1121,14,64,1199
2020-10-15,高铁西九龙,入境,0,0,0,0
2020-10-15,高铁西九龙,出境,0,0,0,0
2020-10-15,红磡,入境,0,0,0,0
2020-10-15,红磡,出境,0,0,0,0
2020-10-15,罗湖,入境,0,0,0,0
2020-10-15,罗湖,出境,0,0,0,0
2020-10-15,落马洲支线,入境,0,0,0,0
2020-10-15,落马洲支线,出境,0,0,0,0
2020-10-15,香园围,入境,0,0,0,0
2020-10-15,香园围,出境,0,0,0,0
2020-10-15,港珠澳大桥,入境,111,4,4,119
2020-10-15,港珠澳大桥,出境,164,7,8,179
2020-10-15,落马洲,入境,0,0,0,0
2020-10-15,落马洲,出境,0,0,0,0
2020-10-15,文锦渡,入境,0,0,0,0
2020-10-15,文锦渡,出境,0,0,0,0
2020-10-15,沙头角,入境,0,0,0,0
2020-10-15,沙头角,出境,0,0,0,0
2020-10-15,深圳湾,入境,1204,164,3,1371
2020-10-15,深圳湾,出境,807,110,5,922
2020-10-15,中国客运码头,入境,0,0,0,0
2020-10-15,中国客运码头,出境,0,0,0,0
2020-10-15,港口管制,入境,0,0,0,0
2020-10-15,港口管制,出境,0,0,0,0
2020-10-15,启德邮轮码头,入境,0,0,0,0
2020-10-15,启德邮轮码头,出境,0,0,0,0
2020-10-15,港澳客轮码头,入境,0,0,0,0
2020-10-15,港澳客轮码头,出境,0,0,0,0
2020-10-15,屯门客运码头,入境,0,0,0,0
2020-10-15,屯门客运码头,出境,0,0,0,0
2020-10-16,机场,入境,1153,5,49,1207
2020-10-16,机场,出境,927,30,42,999
2020-10-16,高铁西九龙,入境,0,0,0,0
2020-10-16,高铁西九龙,出境,0,0,0,0
2020-10-16,红磡,入境,0,0,0,0
2020-10-16,红磡,出境,0,0,0,0
2020-10-16,罗湖,入境,0,0,0,0
2020-10-16,罗湖,出境,0,0,0,0
2020-10-16,落马洲支线,入境,0,0,0,0
2020-10-16,落马洲支线,出境,0,0,0,0
2020-10-16,香园围,入境,0,0,0,0
2020-10-16,香园围,出境,0,0,0,0
2020-10-16,港珠澳大桥,入境,67,7,3,77
2020-10-16,港珠澳大桥,出境,177,7,8,192
2020-10-16,落马洲,入境,0,0,0,0
2020-10-16,落马洲,出境,0,0,0,0
2020-10-16,文锦渡,入境,0,0,0,0
2020-10-16,文锦渡,出境,0,0,0,0
2020-10-16,沙头角,入境,0,0,0,0
2020-10-16,沙头角,出境,0,0,0,0
2020-10-16,深圳湾,入境,950,138,3,1091
2020-10-16,深圳湾,出境,1051,159,6,1216
2020-10-16,中国客运码头,入境,0,0,0,0
2020-10-16,中国客运码头,出境,0,0,0,0
2020-10-16,港口管制,入境,0,0,0,0
2020-10-16,港口管制,出境,0,0,0,0
2020-10-16,启德邮轮码头,入境,0,0,0,0
2020-10-16,启德邮轮码头,出境,0,0,0,0
2020-10-16,港澳客轮码头,入境,0,0,0,0
2020-10-16,港澳客轮码头,出境,0,0,0,0
2020-10-16,屯门客运码头,入境,0,0,0,0
2020-10-16,屯门客运码头,出境,0,0,0,0
2020-10-17,机场,入境,824,8,9,841
2020-10-17,机场,出境,996,27,48,1071
2020-10-17,高铁西九龙,入境,0,0,0,0
2020-10-17,高铁西九龙,出境,0,0,0,0
2020-10-17,红磡,入境,0,0,0,0
2020-10-17,红磡,出境,0,0,0,0
2020-10-17,罗湖,入境,0,0,0,0
2020-10-17,罗湖,出境,0,0,0,0
2020-10-17,落马洲支线,入境,0,0,0,0
2020-10-17,落马洲支线,出境,0,0,0,0
2020-10-17,香园围,入境,0,0,0,0
2020-10-17,香园围,出境,0,0,0,0
2020-10-17,港珠澳大桥,入境,61,6,3,70
2020-10-17,港珠澳大桥,出境,135,20,1,156
2020-10-17,落马洲,入境,0,0,0,0
2020-10-17,落马洲,出境,0,0,0,0
2020-10-17,文锦渡,入境,0,0,0,0
2020-10-17,文锦渡,出境,0,0,0,0
2020-10-17,沙头角,入境,0,0,0,0
2020-10-17,沙头角,出境,0,0,0,0
2020-10-17,深圳湾,入境,985,173,5,1163
2020-10-17,深圳湾,出境,860,129,4,993
2020-10-17,中国客运码头,入境,0,0,0,0
2020-10-17,中国客运码头,出境,0,0,0,0
2020-10-17,港口管制,入境,0,0,0,0
2020-10-17,港口管制,出境,0,0,0,0
2020-10-17,启德邮轮码头,入境,0,0,0,0
2020-10-17,启德邮轮码头,出境,0,0,0,0
2020-10-17,港澳客轮码头,入境,0,0,0,0
2020-10-17,港澳客轮码头,出境,0,0,0,0
2020-10-17,屯门客运码头,入境,0,0,0,0
2020-10-17,屯门客运码头,出境,0,0,0,0
2020-10-18,机场,入境,1057,13,52,1122
2020-10-18,机场,出境,822,26,38,886
2020-10-18,高铁西九龙,入境,0,0,0,0
2020-10-18,高铁西九龙,出境,0,0,0,0
2020-10-18,红磡,入境,0,0,0,0
2020-10-18,红磡,出境,0,0,0,0
2020-10-18,罗湖,入境,0,0,0,0
2020-10-18,罗湖,出境,0,0,0,0
2020-10-18,落马洲支线,入境,0,0,0,0
2020-10-18,落马洲支线,出境,0,0,0,0
2020-10-18,香园围,入境,0,0,0,0
2020-10-18,香园围,出境,0,0,0,0
2020-10-18,港珠澳大桥,入境,70,8,5,83
2020-10-18,港珠澳大桥,出境,82,5,6,93
2020-10-18,落马洲,入境,0,0,0,0
2020-10-18,落马洲,出境,0,0,0,0
2020-10-18,文锦渡,入境,0,0,0,0
2020-10-18,文锦渡,出境,0,0,0,0
2020-10-18,沙头角,入境,0,0,0,0
2020-10-18,沙头角,出境,0,0,0,0
2020-10-18,深圳湾,入境,1363,193,1,1557
2020-10-18,深圳湾,出境,479,84,4,567
2020-10-18,中国客运码头,入境,0,0,0,0
2020-10-18,中国客运码头,出境,0,0,0,0
2020-10-18,港口管制,入境,0,0,0,0
2020-10-18,港口管制,出境,0,0,0,0
2020-10-18,启德邮轮码头,入境,0,0,0,0
2020-10-18,启德邮轮码头,出境,0,0,0,0
2020-10-18,港澳客轮码头,入境,0,0,0,0
2020-10-18,港澳客轮码头,出境,0,0,0,0
2020-10-18,屯门客运码头,入境,0,0,0,0
2020-10-19,屯门客运码头,出境,0,0,0,0
2020-10-19,机场,入境,462,2,31,495
2020-10-19,机场,出境,613,8,28,649
2020-10-19,高铁西九龙,入境,0,0,0,0
2020-10-19,高铁西九龙,出境,0,0,0,0
2020-10-19,红磡,入境,0,0,0,0
2020-10-19,红磡,出境,0,0,0,0
2020-10-19,罗湖,入境,0,0,0,0
2020-10-19,罗湖,出境,0,0,0,0
2020-10-19,落马洲支线,入境,0,0,0,0
2020-10-19,落马洲支线,出境,0,0,0,0
2020-10-19,香园围,入境,0,0,0,0
2020-10-19,香园围,出境,0,0,0,0
2020-10-19,港珠澳大桥,入境,84,3,6,93
2020-10-19,港珠澳大桥,出境,115,4,2,121
2020-10-19,落马洲,入境,0,0,0,0
2020-10-19,落马洲,出境,0,0,0,0
2020-10-19,文锦渡,入境,0,0,0,0
2020-10-19,文锦渡,出境,0,0,0,0
2020-10-19,沙头角,入境,0,0,0,0
2020-10-19,沙头角,出境,0,0,0,0
2020-10-19,深圳湾,入境,1048,121,2,1171
2020-10-19,深圳湾,出境,491,50,3,544
2020-10-19,中国客运码头,入境,0,0,0,0
2020-10-19,中国客运码头,出境,0,0,0,0
2020-10-19,港口管制,入境,0,0,0,0
2020-10-19,港口管制,出境,0,0,0,0
2020-10-19,启德邮轮码头,入境,0,0,0,0
2020-10-19,启德邮轮码头,出境,0,0,0,0
2020-10-19,港澳客轮码头,入境,0,0,0,0
2020-10-19,港澳客轮码头,出境,0,0,0,0
2020-10-19,屯门客运码头,入境,0,0,0,0
2020-10-19,屯门客运码头,出境,0,0,0,0
2020-10-20,机场,入境,512,5,16,533
2020-10-20,机场,出境,842,10,93,945
2020-10-20,高铁西九龙,入境,0,0,0,0
2020-10-20,高铁西九龙,出境,0,0,0,0
2020-10-20,红磡,入境,0,0,0,0
2020-10-20,红磡,出境,0,0,0,0
2020-10-20,罗湖,入境,0,0,0,0
2020-10-20,罗湖,出境,0,0,0,0
2020-10-20,落马洲支线,入境,0,0,0,0
2020-10-20,落马洲支线,出境,0,0,0,0
2020-10-20,香园围,入境,0,0,0,0
2020-10-20,香园围,出境,0,0,0,0
2020-10-20,港珠澳大桥,入境,59,3,70,132
2020-10-20,港珠澳大桥,出境,120,5,1,126
2020-10-20,落马洲,入境,0,0,0,0
2020-10-20,落马洲,出境,0,0,0,0
2020-10-20,文锦渡,入境,0,0,0,0
2020-10-20,文锦渡,出境,0,0,0,0
2020-10-20,沙头角,入境,0,0,0,0
2020-10-20,沙头角,出境,0,0,0,0
2020-10-20,深圳湾,入境,934,148,7,1089
2020-10-20,深圳湾,出境,731,83,4,818
2020-10-20,中国客运码头,入境,0,0,0,0
2020-10-20,中国客运码头,出境,0,0,0,0
2020-10-20,港口管制,入境,0,0,0,0
2020-10-20,港口管制,出境,0,0,0,0
2020-10-20,启德邮轮码头,入境,0,0,0,0
2020-10-20,启德邮轮码头,出境,0,0,0,0
2020-10-20,港澳客轮码头,入境,0,0,0,0
2020-10-20,港澳客轮码头,出境,0,0,0,0
2020-10-20,屯门客运码头,入境,0,0,0,0
2020-10-20,屯门客运码头,出境,0,0,0,0
2020-10-21,机场,入境,770,2,31,803
2020-10-21,机场,出境,715,10,78,803
2020-10-21,高铁西九龙,入境,0,0,0,0
2020-10-21,高铁西九龙,出境,0,0,0,0
2020-10-21,红磡,入境,0,0,0,0
2020-10-21,红磡,出境,0,0,0,0
2020-10-21,罗湖,入境,0,0,0,0
2020-10-21,罗湖,出境,0,0,0,0
2020-10-21,落马洲支线,入境,0,0,0,0
2020-10-21,落马洲支线,出境,0,0,0,0
2020-10-21,香园围,入境,0,0,0,0
2020-10-21,香园围,出境,0,0,0,0
2020-10-21,港珠澳大桥,入境,49,10,7,66
2020-10-21,港珠澳大桥,出境,172,11,2,185
2020-10-21,落马洲,入境,0,0,0,0
2020-10-21,落马洲,出境,0,0,0,0
2020-10-21,文锦渡,入境,0,0,0,0
2020-10-21,文锦渡,出境,0,0,0,0
2020-10-21,沙头角,入境,0,0,0,0
2020-10-21,沙头角,出境,0,0,0,0
2020-10-21,深圳湾,入境,845,148,6,999
2020-10-21,深圳湾,出境,938,123,9,1070
2020-10-21,中国客运码头,入境,0,0,0,0
2020-10-21,中国客运码头,出境,0,0,0,0
2020-10-21,港口管制,入境,0,0,0,0
2020-10-21,港口管制,出境,0,0,0,0
2020-10-21,启德邮轮码头,入境,0,0,0,0
2020-10-21,启德邮轮码头,出境,0,0,0,0
2020-10-21,港澳客轮码头,入境,0,0,0,0
2020-10-21,港澳客轮码头,出境,0,0,0,0
2020-10-21,屯门客运码头,入境,0,0,0,0
2020-10-21,屯门客运码头,出境,0,0,0,0
2020-10-22,机场,入境,517,2,34,553
2020-10-22,机场,出境,661,7,43,711
2020-10-22,高铁西九龙,入境,0,0,0,0
2020-10-22,高铁西九龙,出境,0,0,0,0
2020-10-22,红磡,入境,0,0,0,0
2020-10-22,红磡,出境,0,0,0,0
2020-10-22,罗湖,入境,0,0,0,0
2020-10-22,罗湖,出境,0,0,0,0
2020-10-22,落马洲支线,入境,0,0,0,0
2020-10-22,落马洲支线,出境,0,0,0,0
2020-10-22,香园围,入境,0,0,0,0
2020-10-22,香园围,出境,0,0,0,0
2020-10-22,港珠澳大桥,入境,56,6,7,69
2020-10-22,港珠澳大桥,出境,130,7,2,139
2020-10-22,落马洲,入境,0,0,0,0
2020-10-22,落马洲,出境,0,0,0,0
2020-10-22,文锦渡,入境,0,0,0,0
2020-10-22,文锦渡,出境,0,0,0,0
2020-10-22,沙头角,入境,0,0,0,0
2020-10-22,沙头角,出境,0,0,0,0
2020-10-22,深圳湾,入境,810,156,2,968
2020-10-22,深圳湾,出境,725,102,4,831
2020-10-22,中国客运码头,入境,0,0,0,0
2020-10-22,中国客运码头,出境,0,0,0,0
2020-10-22,港口管制,入境,0,0,0,0
2020-10-22,港口管制,出境,0,0,0,0
2020-10-22,启德邮轮码头,入境,0,0,0,0
2020-10-22,启德邮轮码头,出境,0,0,0,0
2020-10-22,港澳客轮码头,入境,0,0,0,0
2020-10-22,港澳客轮码头,出境,0,0,0,0
2020-10-22,屯门客运码头,入境,0,0,0,0
2020-10-22,屯门客运码头,出境,0,0,0,0
2020-10-23,机场,入境,796,2,42,840
2020-10-23,机场,出境,953,25,58,1036
2020-10-23,高铁西九龙,入境,0,0,0,0
2020-10-23,高铁西九龙,出境,0,0,0,0
2020-10-23,红磡,入境,0,0,0,0
2020-10-23,红磡,出境,0,0,0,0
2020-10-23,罗湖,入境,0,0,0,0
2020-10-23,罗湖,出境,0,0,0,0
2020-10-23,落马洲支线,入境,0,0,0,0
2020-10-23,落马洲支线,出境,0,0,0,0
2020-10-23,香园围,入境,0,0,0,0
2020-10-23,香园围,出境,0,0,0,0
2020-10-23,港珠澳大桥,入境,81,2,5,88
2020-10-23,港珠澳大桥,出境,122,4,4,130
2020-10-23,落马洲,入境,0,0,0,0
2020-10-23,落马洲,出境,0,0,0,0
2020-10-23,文锦渡,入境,0,0,0,0
2020-10-23,文锦渡,出境,0,0,0,0
2020-10-23,沙头角,入境,0,0,0,0
2020-10-23,沙头角,出境,0,0,0,0
2020-10-23,深圳湾,入境,747,156,3,906
2020-10-23,深圳湾,出境,674,80,3,757
2020-10-23,中国客运码头,入境,0,0,0,0
2020-10-23,中国客运码头,出境,0,0,0,0
2020-10-23,港口管制,入境,0,0,0,0
2020-10-23,港口管制,出境,0,0,0,0
2020-10-23,启德邮轮码头,入境,0,0,0,0
2020-10-23,启德邮轮码头,出境,0,0,0,0
2020-10-23,港澳客轮码头,入境,0,0,0,0
2020-10-23,港澳客轮码头,出境,0,0,0,0
2020-10-23,屯门客运码头,入境,0,0,0,0
2020-10-23,屯门客运码头,出境,0,0,0,0
2020-10-24,机场,入境,986,7,27,1020
2020-10-24,机场,出境,904,9,26,939
2020-10-24,高铁西九龙,入境,0,0,0,0
2020-10-24,高铁西九龙,出境,0,0,0,0
2020-10-24,红磡,入境,0,0,0,0
2020-10-24,红磡,出境,0,0,0,0
2020-10-24,罗湖,入境,0,0,0,0
2020-10-24,罗湖,出境,0,0,0,0
2020-10-24,落马洲支线,入境,0,0,0,0
2020-10-24,落马洲支线,出境,0,0,0,0
2020-10-24,香园围,入境,0,0,0,0
2020-10-24,香园围,出境,0,0,0,0
2020-10-24,港珠澳大桥,入境,44,6,3,53
2020-10-24,港珠澳大桥,出境,93,10,6,109
2020-10-24,落马洲,入境,0,0,0,0
2020-10-24,落马洲,出境,0,0,0,0
2020-10-24,文锦渡,入境,0,0,0,0
2020-10-24,文锦渡,出境,0,0,0,0
2020-10-24,沙头角,入境,0,0,0,0
2020-10-24,沙头角,出境,0,0,0,0
2020-10-24,深圳湾,入境,714,134,5,853
2020-10-24,深圳湾,出境,602,75,4,681
2020-10-24,中国客运码头,入境,0,0,0,0
2020-10-24,中国客运码头,出境,0,0,0,0
2020-10-24,港口管制,入境,0,0,0,0
2020-10-24,港口管制,出境,0,0,0,0
2020-10-24,启德邮轮码头,入境,0,0,0,0
2020-10-24,启德邮轮码头,出境,0,0,0,0
2020-10-24,港澳客轮码头,入境,0,0,0,0
2020-10-24,港澳客轮码头,出境,0,0,0,0
2020-10-24,屯门客运码头,入境,0,0,0,0
2020-10-24,屯门客运码头,出境,0,0,0,0
2020-10-25,机场,入境,911,14,38,963
2020-10-25,机场,出境,953,31,48,1032
2020-10-25,高铁西九龙,入境,0,0,0,0
2020-10-25,高铁西九龙,出境,0,0,0,0
2020-10-25,红磡,入境,0,0,0,0
2020-10-25,红磡,出境,0,0,0,0
2020-10-25,罗湖,入境,0,0,0,0
2020-10-25,罗湖,出境,0,0,0,0
2020-10-25,落马洲支线,入境,0,0,0,0
2020-10-25,落马洲支线,出境,0,0,0,0
2020-10-25,香园围,入境,0,0,0,0
2020-10-25,香园围,出境,0,0,0,0
2020-10-25,港珠澳大桥,入境,56,3,9,68
2020-10-25,港珠澳大桥,出境,78,3,6,87
2020-10-25,落马洲,入境,0,0,0,0
2020-10-25,落马洲,出境,0,0,0,0
2020-10-25,文锦渡,入境,0,0,0,0
2020-10-25,文锦渡,出境,0,0,0,0
2020-10-25,沙头角,入境,0,0,0,0
2020-10-25,沙头角,出境,0,0,0,0
2020-10-25,深圳湾,入境,942,228,6,1176
2020-10-25,深圳湾,出境,423,46,3,472
2020-10-25,中国客运码头,入境,0,0,0,0
2020-10-25,中国客运码头,出境,0,0,0,0
2020-10-25,港口管制,入境,0,0,0,0
2020-10-25,港口管制,出境,0,0,0,0
2020-10-25,启德邮轮码头,入境,0,0,0,0
2020-10-25,启德邮轮码头,出境,0,0,0,0
2020-10-25,港澳客轮码头,入境,0,0,0,0
2020-10-25,港澳客轮码头,出境,0,0,0,0
2020-10-25,屯门客运码头,入境,0,0,0,0
2020-10-25,屯门客运码头,出境,0,0,0,0
2020-10-26,机场,入境,575,3,21,599
2020-10-26,机场,出境,542,7,26,575
2020-10-26,高铁西九龙,入境,0,0,0,0
2020-10-26,高铁西九龙,出境,0,0,0,0
2020-10-26,红磡,入境,0,0,0,0
2020-10-26,红磡,出境,0,0,0,0
2020-10-26,罗湖,入境,0,0,0,0
2020-10-26,罗湖,出境,0,0,0,0
2020-10-26,落马洲支线,入境,0,0,0,0
2020-10-26,落马洲支线,出境,0,0,0,0
2020-10-26,香园围,入境,0,0,0,0
2020-10-26,香园围,出境,0,0,0,0
2020-10-26,港珠澳大桥,入境,48,3,8,59
2020-10-26,港珠澳大桥,出境,41,7,1,49
2020-10-26,落马洲,入境,0,0,0,0
2020-10-26,落马洲,出境,0,0,0,0
2020-10-26,文锦渡,入境,0,0,0,0
2020-10-26,文锦渡,出境,0,0,0,0
2020-10-26,沙头角,入境,0,0,0,0
2020-10-26,沙头角,出境,0,0,0,0
2020-10-26,深圳湾,入境,966,137,1,1104
2020-10-26,深圳湾,出境,279,21,5,305
2020-10-26,中国客运码头,入境,0,0,0,0
2020-10-26,中国客运码头,出境,0,0,0,0
2020-10-26,港口管制,入境,0,0,0,0
2020-10-26,港口管制,出境,0,0,0,0
2020-10-26,启德邮轮码头,入境,0,0,0,0
2020-10-26,启德邮轮码头,出境,0,0,0,0
2020-10-26,港澳客轮码头,入境,0,0,0,0
2020-10-26,港澳客轮码头,出境,0,0,0,0
2020-10-26,屯门客运码头,入境,0,0,0,0
2020-10-26,屯门客运码头,出境,0,0,0,0
2020-10-27,机场,入境,534,2,17,553
2020-10-27,机场,出境,546,4,28,578
2020-10-27,高铁西九龙,入境,0,0,0,0
2020-10-27,高铁西九龙,出境,0,0,0,0
2020-10-27,红磡,入境,0,0,0,0
2020-10-27,红磡,出境,0,0,0,0
2020-10-27,罗湖,入境,0,0,0,0
2020-10-27,罗湖,出境,0,0,0,0
2020-10-27,落马洲支线,入境,0,0,0,0
2020-10-27,落马洲支线,出境,0,0,0,0
2020-10-27,香园围,入境,0,0,0,0
2020-10-27,香园围,出境,0,0,0,0
2020-10-27,港珠澳大桥,入境,62,2,3,67
2020-10-27,港珠澳大桥,出境,55,1,1,57
2020-10-27,落马洲,入境,0,0,0,0
2020-10-27,落马洲,出境,0,0,0,0
2020-10-27,文锦渡,入境,0,0,0,0
2020-10-27,文锦渡,出境,0,0,0,0
2020-10-27,沙头角,入境,0,0,0,0
2020-10-27,沙头角,出境,0,0,0,0
2020-10-27,深圳湾,入境,868,128,3,999
2020-10-27,深圳湾,出境,390,30,1,421
2020-10-27,中国客运码头,入境,0,0,0,0
2020-10-27,中国客运码头,出境,0,0,0,0
2020-10-27,港口管制,入境,0,0,0,0
2020-10-27,港口管制,出境,0,0,0,0
2020-10-27,启德邮轮码头,入境,0,0,0,0
2020-10-27,启德邮轮码头,出境,0,0,0,0
2020-10-27,港澳客轮码头,入境,0,0,0,0
2020-10-27,港澳客轮码头,出境,0,0,0,0
2020-10-27,屯门客运码头,入境,0,0,0,0
2020-10-27,屯门客运码头,出境,0,0,0,0
2020-10-28,机场,入境,352,2,23,377
2020-10-28,机场,出境,479,11,28,518
2020-10-28,高铁西九龙,入境,0,0,0,0
2020-10-28,高铁西九龙,出境,0,0,0,0
2020-10-28,红磡,入境,0,0,0,0
2020-10-28,红磡,出境,0,0,0,0
2020-10-28,罗湖,入境,0,0,0,0
2020-10-28,罗湖,出境,0,0,0,0
2020-10-28,落马洲支线,入境,0,0,0,0
2020-10-28,落马洲支线,出境,0,0,0,0
2020-10-28,香园围,入境,0,0,0,0
2020-10-28,香园围,出境,0,0,0,0
2020-10-28,港珠澳大桥,入境,64,2,6,72
2020-10-28,港珠澳大桥,出境,141,2,4,147
2020-10-28,落马洲,入境,0,0,0,0
2020-10-28,落马洲,出境,0,0,0,0
2020-10-28,文锦渡,入境,0,0,0,0
2020-10-28,文锦渡,出境,0,0,0,0
2020-10-28,沙头角,入境,0,0,0,0
2020-10-28,沙头角,出境,0,0,0,0
2020-10-28,深圳湾,入境,557,108,4,669
2020-10-28,深圳湾,出境,737,79,4,820
2020-10-28,中国客运码头,入境,0,0,0,0
2020-10-28,中国客运码头,出境,0,0,0,0
2020-10-28,港口管制,入境,0,0,0,0
2020-10-28,港口管制,出境,0,0,0,0
2020-10-28,启德邮轮码头,入境,0,0,0,0
2020-10-28,启德邮轮码头,出境,0,0,0,0
2020-10-28,港澳客轮码头,入境,0,0,0,0
2020-10-28,港澳客轮码头,出境,0,0,0,0
2020-10-28,屯门客运码头,入境,0,0,0,0
2020-10-28,屯门客运码头,出境,0,0,0,0
2020-10-29,机场,入境,534,6,28,568
2020-10-29,机场,出境,731,8,45,784
2020-10-29,高铁西九龙,入境,0,0,0,0
2020-10-29,高铁西九龙,出境,0,0,0,0
2020-10-29,红磡,入境,0,0,0,0
2020-10-29,红磡,出境,0,0,0,0
2020-10-29,罗湖,入境,0,0,0,0
2020-10-29,罗湖,出境,0,0,0,0
2020-10-29,落马洲支线,入境,0,0,0,0
2020-10-29,落马洲支线,出境,0,0,0,0
2020-10-29,香园围,入境,0,0,0,0
2020-10-29,香园围,出境,0,0,0,0
2020-10-29,港珠澳大桥,入境,62,3,5,70
2020-10-29,港珠澳大桥,出境,144,11,4,159
2020-10-29,落马洲,入境,0,0,0,0
2020-10-29,落马洲,出境,0,0,0,0
2020-10-29,文锦渡,入境,0,0,0,0
2020-10-29,文锦渡,出境,0,0,0,0
2020-10-29,沙头角,入境,0,0,0,0
2020-10-29,沙头角,出境,0,0,0,0
2020-10-29,深圳湾,入境,478,81,1,560
2020-10-29,深圳湾,出境,814,90,2,906
2020-10-29,中国客运码头,入境,0,0,0,0
2020-10-29,中国客运码头,出境,0,0,0,0
2020-10-29,港口管制,入境,0,0,0,0
2020-10-29,港口管制,出境,0,0,0,0
2020-10-29,启德邮轮码头,入境,0,0,0,0
2020-10-29,启德邮轮码头,出境,0,0,0,0
2020-10-29,港澳客轮码头,入境,0,0,0,0
2020-10-29,港澳客轮码头,出境,0,0,0,0
2020-10-29,屯门客运码头,入境,0,0,0,0
2020-10-29,屯门客运码头,出境,0,0,0,0
2020-10-30,机场,入境,890,4,37,931
2020-10-30,机场,出境,986,26,57,1069
2020-10-30,高铁西九龙,入境,0,0,0,0
2020-10-30,高铁西九龙,出境,0,0,0,0
2020-10-30,红磡,入境,0,0,0,0
2020-10-30,红磡,出境,0,0,0,0
2020-10-30,罗湖,入境,0,0,0,0
2020-10-30,罗湖,出境,0,0,0,0
2020-10-30,落马洲支线,入境,0,0,0,0
2020-10-30,落马洲支线,出境,0,0,0,0
2020-10-30,香园围,入境,0,0,0,0
2020-10-30,香园围,出境,0,0,0,0
2020-10-30,港珠澳大桥,入境,55,3,6,64
2020-10-30,港珠澳大桥,出境,137,9,6,152
2020-10-30,落马洲,入境,0,0,0,0
2020-10-30,落马洲,出境,0,0,0,0
2020-10-30,文锦渡,入境,0,0,0,0
2020-10-30,文锦渡,出境,0,0,0,0
2020-10-30,沙头角,入境,0,0,0,0
2020-10-30,沙头角,出境,0,0,0,0
2020-10-30,深圳湾,入境,544,102,2,648
2020-10-30,深圳湾,出境,698,72,6,776
2020-10-30,中国客运码头,入境,0,0,0,0
2020-10-30,中国客运码头,出境,0,0,0,0
2020-10-30,港口管制,入境,0,0,0,0
2020-10-30,港口管制,出境,0,0,0,0
2020-10-30,启德邮轮码头,入境,0,0,0,0
2020-10-30,启德邮轮码头,出境,0,0,0,0
2020-10-30,港澳客轮码头,入境,0,0,0,0
2020-10-30,港澳客轮码头,出境,0,0,0,0
2020-10-30,屯门客运码头,入境,0,0,0,0
2020-10-30,屯门客运码头,出境,0,0,0,0
2020-10-31,机场,入境,776,5,19,800
2020-10-31,机场,出境,1262,19,36,1317
2020-10-31,高铁西九龙,入境,0,0,0,0
2020-10-31,高铁西九龙,出境,0,0,0,0
2020-10-31,红磡,入境,0,0,0,0
2020-10-31,红磡,出境,0,0,0,0
2020-10-31,罗湖,入境,0,0,0,0
2020-10-31,罗湖,出境,0,0,0,0
2020-10-31,落马洲支线,入境,0,0,0,0
2020-10-31,落马洲支线,出境,0,0,0,0
2020-10-31,香园围,入境,0,0,0,0
2020-10-31,香园围,出境,0,0,0,0
2020-10-31,港珠澳大桥,入境,48,3,4,55
2020-10-31,港珠澳大桥,出境,123,8,0,131
2020-10-31,落马洲,入境,0,0,0,0
2020-10-31,落马洲,出境,0,0,0,0
2020-10-31,文锦渡,入境,0,0,0,0
2020-10-31,文锦渡,出境,0,0,0,0
2020-10-31,沙头角,入境,0,0,0,0
2020-10-31,沙头角,出境,0,0,0,0
2020-10-31,深圳湾,入境,516,131,4,651
2020-10-31,深圳湾,出境,614,72,11,697
2020-10-31,中国客运码头,入境,0,0,0,0
2020-10-31,中国客运码头,出境,0,0,0,0
2020-10-31,港口管制,入境,0,0,0,0
2020-10-31,港口管制,出境,0,0,0,0
2020-10-31,启德邮轮码头,入境,0,0,0,0
2020-10-31,启德邮轮码头,出境,0,0,0,0
2020-10-31,港澳客轮码头,入境,0,0,0,0
2020-10-31,港澳客轮码头,出境,0,0,0,0
2020-10-31,屯门客运码头,入境,0,0,0,0
2020-10-31,屯门客运码头,出境,0,0,0,0
2020-11-01,机场,入境,1021,1,47,1069
2020-11-01,机场,出境,935,8,39,982
2020-11-01,高铁西九龙,入境,0,0,0,0
2020-11-01,高铁西九龙,出境,0,0,0,0
2020-11-01,红磡,入境,0,0,0,0
2020-11-01,红磡,出境,0,0,0,0
2020-11-01,罗湖,入境,0,0,0,0
2020-11-01,罗湖,出境,0,0,0,0
2020-11-01,落马洲支线,入境,0,0,0,0
2020-11-01,落马洲支线,出境,0,0,0,0
2020-11-01,香园围,入境,0,0,0,0
2020-11-01,香园围,出境,0,0,0,0
2020-11-01,港珠澳大桥,入境,61,8,4,73
2020-11-01,港珠澳大桥,出境,122,5,4,131
2020-11-01,落马洲,入境,0,0,0,0
2020-11-01,落马洲,出境,0,0,0,0
2020-11-01,文锦渡,入境,0,0,0,0
2020-11-01,文锦渡,出境,0,0,0,0
2020-11-01,沙头角,入境,0,0,0,0
2020-11-01,沙头角,出境,0,0,0,0
2020-11-01,深圳湾,入境,1075,173,8,1256
2020-11-01,深圳湾,出境,444,69,3,516
2020-11-01,中国客运码头,入境,0,0,0,0
2020-11-01,中国客运码头,出境,0,0,0,0
2020-11-01,港口管制,入境,0,0,0,0
2020-11-01,港口管制,出境,0,0,0,0
2020-11-01,启德邮轮码头,入境,0,0,0,0
2020-11-01,启德邮轮码头,出境,0,0,0,0
2020-11-01,港澳客轮码头,入境,0,0,0,0
2020-11-01,港澳客轮码头,出境,0,0,0,0
2020-11-01,屯门客运码头,入境,0,0,0,0
2020-11-01,屯门客运码头,出境,0,0,0,0
2020-11-02,机场,入境,503,0,25,528
2020-11-02,机场,出境,472,9,17,498
2020-11-02,高铁西九龙,入境,0,0,0,0
2020-11-02,高铁西九龙,出境,0,0,0,0
2020-11-02,红磡,入境,0,0,0,0
2020-11-02,红磡,出境,0,0,0,0
2020-11-02,罗湖,入境,0,0,0,0
2020-11-02,罗湖,出境,0,0,0,0
2020-11-02,落马洲支线,入境,0,0,0,0
2020-11-02,落马洲支线,出境,0,0,0,0
2020-11-02,香园围,入境,0,0,0,0
2020-11-02,香园围,出境,0,0,0,0
2020-11-02,港珠澳大桥,入境,70,6,0,76
2020-11-02,港珠澳大桥,出境,81,3,0,84
2020-11-02,落马洲,入境,0,0,0,0
2020-11-02,落马洲,出境,0,0,0,0
2020-11-02,文锦渡,入境,0,0,0,0
2020-11-02,文锦渡,出境,0,0,0,0
2020-11-02,沙头角,入境,0,0,0,0
2020-11-02,沙头角,出境,0,0,0,0
2020-11-02,深圳湾,入境,838,122,1,961
2020-11-02,深圳湾,出境,357,44,2,403
2020-11-02,中国客运码头,入境,0,0,0,0
2020-11-02,中国客运码头,出境,0,0,0,0
2020-11-02,港口管制,入境,0,0,0,0
2020-11-02,港口管制,出境,0,0,0,0
2020-11-02,启德邮轮码头,入境,0,0,0,0
2020-11-02,启德邮轮码头,出境,0,0,0,0
2020-11-02,港澳客轮码头,入境,0,0,0,0
2020-11-02,港澳客轮码头,出境,0,0,0,0
2020-11-02,屯门客运码头,入境,0,0,0,0
2020-11-02,屯门客运码头,出境,0,0,0,0
2020-11-03,机场,入境,717,14,32,763
2020-11-03,机场,出境,1139,20,96,1255
2020-11-03,高铁西九龙,入境,0,0,0,0
2020-11-03,高铁西九龙,出境,0,0,0,0
2020-11-03,红磡,入境,0,0,0,0
2020-11-03,红磡,出境,0,0,0,0
2020-11-03,罗湖,入境,0,0,0,0
2020-11-03,罗湖,出境,0,0,0,0
2020-11-03,落马洲支线,入境,0,0,0,0
2020-11-03,落马洲支线,出境,0,0,0,0
2020-11-03,香园围,入境,0,0,0,0
2020-11-03,香园围,出境,0,0,0,0
2020-11-03,港珠澳大桥,入境,59,4,6,69
2020-11-03,港珠澳大桥,出境,162,8,3,173
2020-11-03,落马洲,入境,0,0,0,0
2020-11-03,落马洲,出境,0,0,0,0
2020-11-03,文锦渡,入境,0,0,0,0
2020-11-03,文锦渡,出境,0,0,0,0
2020-11-03,沙头角,入境,0,0,0,0
2020-11-03,沙头角,出境,0,0,0,0
2020-11-03,深圳湾,入境,723,137,2,862
2020-11-03,深圳湾,出境,776,85,7,868
2020-11-03,中国客运码头,入境,0,0,0,0
2020-11-03,中国客运码头,出境,0,0,0,0
2020-11-03,港口管制,入境,0,0,0,0
2020-11-03,港口管制,出境,0,0,0,0
2020-11-03,启德邮轮码头,入境,0,0,0,0
2020-11-03,启德邮轮码头,出境,0,0,0,0
2020-11-03,港澳客轮码头,入境,0,0,0,0
2020-11-03,港澳客轮码头,出境,0,0,0,0
2020-11-03,屯门客运码头,入境,0,0,0,0
2020-11-03,屯门客运码头,出境,0,0,0,0
2020-11-04,机场,入境,829,7,33,869
2020-11-04,机场,出境,819,6,124,949
2020-11-04,高铁西九龙,入境,0,0,0,0
2020-11-04,高铁西九龙,出境,0,0,0,0
2020-11-04,红磡,入境,0,0,0,0
2020-11-04,红磡,出境,0,0,0,0
2020-11-04,罗湖,入境,0,0,0,0
2020-11-04,罗湖,出境,0,0,0,0
2020-11-04,落马洲支线,入境,0,0,0,0
2020-11-04,落马洲支线,出境,0,0,0,0
2020-11-04,香园围,入境,0,0,0,0
2020-11-04,香园围,出境,0,0,0,0
2020-11-04,港珠澳大桥,入境,61,2,30,93
2020-11-04,港珠澳大桥,出境,158,14,5,177
2020-11-04,落马洲,入境,0,0,0,0
2020-11-04,落马洲,出境,0,0,0,0
2020-11-04,文锦渡,入境,0,0,0,0
2020-11-04,文锦渡,出境,0,0,0,0
2020-11-04,沙头角,入境,0,0,0,0
2020-11-04,沙头角,出境,0,0,0,0
2020-11-04,深圳湾,入境,664,111,3,778
2020-11-04,深圳湾,出境,742,97,8,847
2020-11-04,中国客运码头,入境,0,0,0,0
2020-11-04,中国客运码头,出境,0,0,0,0
2020-11-04,港口管制,入境,0,0,0,0
2020-11-04,港口管制,出境,0,0,0,0
2020-11-04,启德邮轮码头,入境,0,0,0,0
2020-11-04,启德邮轮码头,出境,0,0,0,0
2020-11-04,港澳客轮码头,入境,0,0,0,0
2020-11-04,港澳客轮码头,出境,0,0,0,0
2020-11-04,屯门客运码头,入境,0,0,0,0
2020-11-04,屯门客运码头,出境,0,0,0,0
2020-11-05,机场,入境,1007,1,30,1038
2020-11-05,机场,出境,560,3,84,647
2020-11-05,高铁西九龙,入境,0,0,0,0
2020-11-05,高铁西九龙,出境,0,0,0,0
2020-11-05,红磡,入境,0,0,0,0
2020-11-05,红磡,出境,0,0,0,0
2020-11-05,罗湖,入境,0,0,0,0
2020-11-05,罗湖,出境,0,0,0,0
2020-11-05,落马洲支线,入境,0,0,0,0
2020-11-05,落马洲支线,出境,0,0,0,0
2020-11-05,香园围,入境,0,0,0,0
2020-11-05,香园围,出境,0,0,0,0
2020-11-05,港珠澳大桥,入境,69,5,61,135
2020-11-05,港珠澳大桥,出境,109,10,5,124
2020-11-05,落马洲,入境,0,0,0,0
2020-11-05,落马洲,出境,0,0,0,0
2020-11-05,文锦渡,入境,0,0,0,0
2020-11-05,文锦渡,出境,0,0,0,0
2020-11-05,沙头角,入境,0,0,0,0
2020-11-05,沙头角,出境,0,0,0,0
2020-11-05,深圳湾,入境,691,92,1,784
2020-11-05,深圳湾,出境,631,109,5,745
2020-11-05,中国客运码头,入境,0,0,0,0
2020-11-05,中国客运码头,出境,0,0,0,0
2020-11-05,港口管制,入境,0,0,0,0
2020-11-05,港口管制,出境,0,0,0,0
2020-11-05,启德邮轮码头,入境,0,0,0,0
2020-11-05,启德邮轮码头,出境,0,0,0,0
2020-11-05,港澳客轮码头,入境,0,0,0,0
2020-11-05,港澳客轮码头,出境,0,0,0,0
2020-11-05,屯门客运码头,入境,0,0,0,0
2020-11-05,屯门客运码头,出境,0,0,0,0
2020-11-06,机场,入境,931,5,40,976
2020-11-06,机场,出境,832,10,55,897
2020-11-06,高铁西九龙,入境,0,0,0,0
2020-11-06,高铁西九龙,出境,0,0,0,0
2020-11-06,红磡,入境,0,0,0,0
2020-11-06,红磡,出境,0,0,0,0
2020-11-06,罗湖,入境,0,0,0,0
2020-11-06,罗湖,出境,0,0,0,0
2020-11-06,落马洲支线,入境,0,0,0,0
2020-11-06,落马洲支线,出境,0,0,0,0
2020-11-06,香园围,入境,0,0,0,0
2020-11-06,香园围,出境,0,0,0,0
2020-11-06,港珠澳大桥,入境,58,1,7,66
2020-11-06,港珠澳大桥,出境,59,10,6,75
2020-11-06,落马洲,入境,0,0,0,0
2020-11-06,落马洲,出境,0,0,0,0
2020-11-06,文锦渡,入境,0,0,0,0
2020-11-06,文锦渡,出境,0,0,0,0
2020-11-06,沙头角,入境,0,0,0,0
2020-11-06,沙头角,出境,0,0,0,0
2020-11-06,深圳湾,入境,669,96,2,767
2020-11-06,深圳湾,出境,603,86,7,696
2020-11-06,中国客运码头,入境,0,0,0,0
2020-11-06,中国客运码头,出境,0,0,0,0
2020-11-06,港口管制,入境,0,0,0,0
2020-11-06,港口管制,出境,0,0,0,0
2020-11-06,启德邮轮码头,入境,0,0,0,0
2020-11-06,启德邮轮码头,出境,0,0,0,0
2020-11-06,港澳客轮码头,入境,0,0,0,0
2020-11-06,港澳客轮码头,出境,0,0,0,0
2020-11-06,屯门客运码头,入境,0,0,0,0
2020-11-06,屯门客运码头,出境,0,0,0,0
2020-11-07,机场,入境,876,8,26,910
2020-11-07,机场,出境,738,9,28,775
2020-11-07,高铁西九龙,入境,0,0,0,0
2020-11-07,高铁西九龙,出境,0,0,0,0
2020-11-07,红磡,入境,0,0,0,0
2020-11-07,红磡,出境,0,0,0,0
2020-11-07,罗湖,入境,0,0,0,0
2020-11-07,罗湖,出境,0,0,0,0
2020-11-07,落马洲支线,入境,0,0,0,0
2020-11-07,落马洲支线,出境,0,0,0,0
2020-11-07,香园围,入境,0,0,0,0
2020-11-07,香园围,出境,0,0,0,0
2020-11-07,港珠澳大桥,入境,36,3,0,39
2020-11-07,港珠澳大桥,出境,92,12,4,108
2020-11-07,落马洲,入境,0,0,0,0
2020-11-07,落马洲,出境,0,0,0,0
2020-11-07,文锦渡,入境,0,0,0,0
2020-11-07,文锦渡,出境,0,0,0,0
2020-11-07,沙头角,入境,0,0,0,0
2020-11-07,沙头角,出境,0,0,0,0
2020-11-07,深圳湾,入境,702,117,2,821
2020-11-07,深圳湾,出境,467,69,3,539
2020-11-07,中国客运码头,入境,0,0,0,0
2020-11-07,中国客运码头,出境,0,0,0,0
2020-11-07,港口管制,入境,0,0,0,0
2020-11-07,港口管制,出境,0,0,0,0
2020-11-07,启德邮轮码头,入境,0,0,0,0
2020-11-07,启德邮轮码头,出境,0,0,0,0
2020-11-07,港澳客轮码头,入境,0,0,0,0
2020-11-07,港澳客轮码头,出境,0,0,0,0
2020-11-07,屯门客运码头,入境,0,0,0,0
2020-11-07,屯门客运码头,出境,0,0,0,0
2020-11-08,机场,入境,1089,4,63,1156
2020-11-08,机场,出境,816,22,60,898
2020-11-08,高铁西九龙,入境,0,0,0,0
2020-11-08,高铁西九龙,出境,0,0,0,0
2020-11-08,红磡,入境,0,0,0,0
2020-11-08,红磡,出境,0,0,0,0
2020-11-08,罗湖,入境,0,0,0,0
2020-11-08,罗湖,出境,0,0,0,0
2020-11-08,落马洲支线,入境,0,0,0,0
2020-11-08,落马洲支线,出境,0,0,0,0
2020-11-08,香园围,入境,0,0,0,0
2020-11-08,香园围,出境,0,0,0,0
2020-11-08,港珠澳大桥,入境,64,4,3,71
2020-11-08,港珠澳大桥,出境,67,32,1,100
2020-11-08,落马洲,入境,0,0,0,0
2020-11-08,落马洲,出境,0,0,0,0
2020-11-08,文锦渡,入境,0,0,0,0
2020-11-08,文锦渡,出境,0,0,0,0
2020-11-08,沙头角,入境,0,0,0,0
2020-11-08,沙头角,出境,0,0,0,0
2020-11-08,深圳湾,入境,906,130,2,1038
2020-11-08,深圳湾,出境,339,78,3,420
2020-11-08,中国客运码头,入境,0,0,0,0
2020-11-08,中国客运码头,出境,0,0,0,0
2020-11-08,港口管制,入境,0,0,0,0
2020-11-08,港口管制,出境,0,0,0,0
2020-11-08,启德邮轮码头,入境,0,0,0,0
2020-11-08,启德邮轮码头,出境,0,0,0,0
2020-11-08,港澳客轮码头,入境,0,0,0,0
2020-11-08,港澳客轮码头,出境,0,0,0,0
2020-11-08,屯门客运码头,入境,0,0,0,0
2020-11-08,屯门客运码头,出境,0,0,0,0
2020-11-09,机场,入境,621,0,19,640
2020-11-09,机场,出境,379,13,20,412
2020-11-09,高铁西九龙,入境,0,0,0,0
2020-11-09,高铁西九龙,出境,0,0,0,0
2020-11-09,红磡,入境,0,0,0,0
2020-11-09,红磡,出境,0,0,0,0
2020-11-09,罗湖,入境,0,0,0,0
2020-11-09,罗湖,出境,0,0,0,0
2020-11-09,落马洲支线,入境,0,0,0,0
2020-11-09,落马洲支线,出境,0,0,0,0
2020-11-09,香园围,入境,0,0,0,0
2020-11-09,香园围,出境,0,0,0,0
2020-11-09,港珠澳大桥,入境,62,5,5,72
2020-11-09,港珠澳大桥,出境,62,3,5,70
2020-11-09,落马洲,入境,0,0,0,0
2020-11-09,落马洲,出境,0,0,0,0
2020-11-09,文锦渡,入境,0,0,0,0
2020-11-09,文锦渡,出境,0,0,0,0
2020-11-09,沙头角,入境,0,0,0,0
2020-11-09,沙头角,出境,0,0,0,0
2020-11-09,深圳湾,入境,773,85,1,859
2020-11-09,深圳湾,出境,352,53,3,408
2020-11-09,中国客运码头,入境,0,0,0,0
2020-11-09,中国客运码头,出境,0,0,0,0
2020-11-09,港口管制,入境,0,0,0,0
2020-11-09,港口管制,出境,0,0,0,0
2020-11-09,启德邮轮码头,入境,0,0,0,0
2020-11-09,启德邮轮码头,出境,0,0,0,0
2020-11-09,港澳客轮码头,入境,0,0,0,0
2020-11-09,港澳客轮码头,出境,0,0,0,0
2020-11-09,屯门客运码头,入境,0,0,0,0
2020-11-09,屯门客运码头,出境,0,0,0,0
2020-11-10,机场,入境,952,6,36,994
2020-11-10,机场,出境,964,20,36,1020
2020-11-10,高铁西九龙,入境,0,0,0,0
2020-11-10,高铁西九龙,出境,0,0,0,0
2020-11-10,红磡,入境,0,0,0,0
2020-11-10,红磡,出境,0,0,0,0
2020-11-10,罗湖,入境,0,0,0,0
2020-11-10,罗湖,出境,0,0,0,0
2020-11-10,落马洲支线,入境,0,0,0,0
2020-11-10,落马洲支线,出境,0,0,0,0
2020-11-10,香园围,入境,0,0,0,0
2020-11-10,香园围,出境,0,0,0,0
2020-11-10,港珠澳大桥,入境,83,4,6,93
2020-11-10,港珠澳大桥,出境,114,6,3,123
2020-11-10,落马洲,入境,0,0,0,0
2020-11-10,落马洲,出境,0,0,0,0
2020-11-10,文锦渡,入境,0,0,0,0
2020-11-10,文锦渡,出境,0,0,0,0
2020-11-10,沙头角,入境,0,0,0,0
2020-11-10,沙头角,出境,0,0,0,0
2020-11-10,深圳湾,入境,736,93,2,831
2020-11-10,深圳湾,出境,739,82,10,831
2020-11-10,中国客运码头,入境,0,0,0,0
2020-11-10,中国客运码头,出境,0,0,0,0
2020-11-10,港口管制,入境,0,0,0,0
2020-11-10,港口管制,出境,0,0,0,0
2020-11-10,启德邮轮码头,入境,0,0,0,0
2020-11-10,启德邮轮码头,出境,0,0,0,0
2020-11-10,港澳客轮码头,入境,0,0,0,0
2020-11-10,港澳客轮码头,出境,0,0,0,0
2020-11-10,屯门客运码头,入境,0,0,0,0
2020-11-10,屯门客运码头,出境,0,0,0,0
2020-11-11,机场,入境,1321,2,52,1375
2020-11-11,机场,出境,508,8,42,558
2020-11-11,高铁西九龙,入境,0,0,0,0
2020-11-11,高铁西九龙,出境,0,0,0,0
2020-11-11,红磡,入境,0,0,0,0
2020-11-11,红磡,出境,0,0,0,0
2020-11-11,罗湖,入境,0,0,0,0
2020-11-11,罗湖,出境,0,0,0,0
2020-11-11,落马洲支线,入境,0,0,0,0
2020-11-11,落马洲支线,出境,0,0,0,0
2020-11-11,香园围,入境,0,0,0,0
2020-11-11,香园围,出境,0,0,0,0
2020-11-11,港珠澳大桥,入境,44,4,4,52
2020-11-11,港珠澳大桥,出境,94,7,1,102
2020-11-11,落马洲,入境,0,0,0,0
2020-11-11,落马洲,出境,0,0,0,0
2020-11-11,文锦渡,入境,0,0,0,0
2020-11-11,文锦渡,出境,0,0,0,0
2020-11-11,沙头角,入境,0,0,0,0
2020-11-11,沙头角,出境,0,0,0,0
2020-11-11,深圳湾,入境,658,88,3,749
2020-11-11,深圳湾,出境,676,84,3,763
2020-11-11,中国客运码头,入境,0,0,0,0
2020-11-11,中国客运码头,出境,0,0,0,0
2020-11-11,港口管制,入境,0,0,0,0
2020-11-11,港口管制,出境,0,0,0,0
2020-11-11,启德邮轮码头,入境,0,0,0,0
2020-11-11,启德邮轮码头,出境,0,0,0,0
2020-11-11,港澳客轮码头,入境,0,0,0,0
2020-11-11,港澳客轮码头,出境,0,0,0,0
2020-11-11,屯门客运码头,入境,0,0,0,0
2020-11-11,屯门客运码头,出境,0,0,0,0
2020-11-12,机场,入境,1646,4,61,1711
2020-11-12,机场,出境,589,7,74,670
2020-11-12,高铁西九龙,入境,0,0,0,0
2020-11-12,高铁西九龙,出境,0,0,0,0
2020-11-12,红磡,入境,0,0,0,0
2020-11-12,红磡,出境,0,0,0,0
2020-11-12,罗湖,入境,0,0,0,0
2020-11-12,罗湖,出境,0,0,0,0
2020-11-12,落马洲支线,入境,0,0,0,0
2020-11-12,落马洲支线,出境,0,0,0,0
2020-11-12,香园围,入境,0,0,0,0
2020-11-12,香园围,出境,0,0,0,0
2020-11-12,港珠澳大桥,入境,54,1,22,77
2020-11-12,港珠澳大桥,出境,101,7,3,111
2020-11-12,落马洲,入境,0,0,0,0
2020-11-12,落马洲,出境,0,0,0,0
2020-11-12,文锦渡,入境,0,0,0,0
2020-11-12,文锦渡,出境,0,0,0,0
2020-11-12,沙头角,入境,0,0,0,0
2020-11-12,沙头角,出境,0,0,0,0
2020-11-12,深圳湾,入境,616,102,4,722
2020-11-12,深圳湾,出境,587,67,4,658
2020-11-12,中国客运码头,入境,0,0,0,0
2020-11-12,中国客运码头,出境,0,0,0,0
2020-11-12,港口管制,入境,0,0,0,0
2020-11-12,港口管制,出境,0,0,0,0
2020-11-12,启德邮轮码头,入境,0,0,0,0
2020-11-12,启德邮轮码头,出境,0,0,0,0
2020-11-12,港澳客轮码头,入境,0,0,0,0
2020-11-12,港澳客轮码头,出境,0,0,0,0
2020-11-12,屯门客运码头,入境,0,0,0,0
2020-11-12,屯门客运码头,出境,0,0,0,0
2020-11-13,机场,入境,806,1,26,833
2020-11-13,机场,出境,706,8,49,763
2020-11-13,高铁西九龙,入境,0,0,0,0
2020-11-13,高铁西九龙,出境,0,0,0,0
2020-11-13,红磡,入境,0,0,0,0
2020-11-13,红磡,出境,0,0,0,0
2020-11-13,罗湖,入境,0,0,0,0
2020-11-13,罗湖,出境,0,0,0,0
2020-11-13,落马洲支线,入境,0,0,0,0
2020-11-13,落马洲支线,出境,0,0,0,0
2020-11-13,香园围,入境,0,0,0,0
2020-11-13,香园围,出境,0,0,0,0
2020-11-13,港珠澳大桥,入境,46,7,3,56
2020-11-13,港珠澳大桥,出境,109,10,6,125
2020-11-13,落马洲,入境,0,0,0,0
2020-11-13,落马洲,出境,0,0,0,0
2020-11-13,文锦渡,入境,0,0,0,0
2020-11-13,文锦渡,出境,0,0,0,0
2020-11-13,沙头角,入境,0,0,0,0
2020-11-13,沙头角,出境,0,0,0,0
2020-11-13,深圳湾,入境,604,99,2,705
2020-11-13,深圳湾,出境,569,68,7,644
2020-11-13,中国客运码头,入境,0,0,0,0
2020-11-13,中国客运码头,出境,0,0,0,0
2020-11-13,港口管制,入境,0,0,0,0
2020-11-13,港口管制,出境,0,0,0,0
2020-11-13,启德邮轮码头,入境,0,0,0,0
2020-11-13,启德邮轮码头,出境,0,0,0,0
2020-11-13,港澳客轮码头,入境,0,0,0,0
2020-11-13,港澳客轮码头,出境,0,0,0,0
2020-11-13,屯门客运码头,入境,0,0,0,0
2020-11-13,屯门客运码头,出境,0,0,0,0
2020-11-14,机场,入境,714,3,19,736
2020-11-14,机场,出境,885,15,34,934
2020-11-14,高铁西九龙,入境,0,0,0,0
2020-11-14,高铁西九龙,出境,0,0,0,0
2020-11-14,红磡,入境,0,0,0,0
2020-11-14,红磡,出境,0,0,0,0
2020-11-14,罗湖,入境,0,0,0,0
2020-11-14,罗湖,出境,0,0,0,0
2020-11-14,落马洲支线,入境,0,0,0,0
2020-11-14,落马洲支线,出境,0,0,0,0
2020-11-14,香园围,入境,0,0,0,0
2020-11-14,香园围,出境,0,0,0,0
2020-11-14,港珠澳大桥,入境,47,4,1,52
2020-11-14,港珠澳大桥,出境,107,6,2,115
2020-11-14,落马洲,入境,0,0,0,0
2020-11-14,落马洲,出境,0,0,0,0
2020-11-14,文锦渡,入境,0,0,0,0
2020-11-14,文锦渡,出境,0,0,0,0
2020-11-14,沙头角,入境,0,0,0,0
2020-11-14,沙头角,出境,0,0,0,0
2020-11-14,深圳湾,入境,525,112,6,643
2020-11-14,深圳湾,出境,540,64,2,606
2020-11-14,中国客运码头,入境,0,0,0,0
2020-11-14,中国客运码头,出境,0,0,0,0
2020-11-14,港口管制,入境,0,0,0,0
2020-11-14,港口管制,出境,0,0,0,0
2020-11-14,启德邮轮码头,入境,0,0,0,0
2020-11-14,启德邮轮码头,出境,0,0,0,0
2020-11-14,港澳客轮码头,入境,0,0,0,0
2020-11-14,港澳客轮码头,出境,0,0,0,0
2020-11-14,屯门客运码头,入境,0,0,0,0
2020-11-14,屯门客运码头,出境,0,0,0,0
2020-11-15,机场,入境,969,6,38,1013
2020-11-15,机场,出境,1174,30,55,1259
2020-11-15,高铁西九龙,入境,0,0,0,0
2020-11-15,高铁西九龙,出境,0,0,0,0
2020-11-15,红磡,入境,0,0,0,0
2020-11-15,红磡,出境,0,0,0,0
2020-11-15,罗湖,入境,0,0,0,0
2020-11-15,罗湖,出境,0,0,0,0
2020-11-15,落马洲支线,入境,0,0,0,0
2020-11-15,落马洲支线,出境,0,0,0,0
2020-11-15,香园围,入境,0,0,0,0
2020-11-15,香园围,出境,0,0,0,0
2020-11-15,港珠澳大桥,入境,34,4,6,44
2020-11-15,港珠澳大桥,出境,62,8,0,70
2020-11-15,落马洲,入境,0,0,0,0
2020-11-15,落马洲,出境,0,0,0,0
2020-11-15,文锦渡,入境,0,0,0,0
2020-11-15,文锦渡,出境,0,0,0,0
2020-11-15,沙头角,入境,0,0,0,0
2020-11-15,沙头角,出境,0,0,0,0
2020-11-15,深圳湾,入境,742,114,2,858
2020-11-15,深圳湾,出境,358,50,1,409
2020-11-15,中国客运码头,入境,0,0,0,0
2020-11-15,中国客运码头,出境,0,0,0,0
2020-11-15,港口管制,入境,0,0,0,0
2020-11-15,港口管制,出境,0,0,0,0
2020-11-15,启德邮轮码头,入境,0,0,0,0
2020-11-15,启德邮轮码头,出境,0,0,0,0
2020-11-15,港澳客轮码头,入境,0,0,0,0
2020-11-15,港澳客轮码头,出境,0,0,0,0
2020-11-15,屯门客运码头,入境,0,0,0,0
2020-11-15,屯门客运码头,出境,0,0,0,0
2020-11-16,机场,入境,366,14,17,397
2020-11-16,机场,出境,424,13,14,451
2020-11-16,高铁西九龙,入境,0,0,0,0
2020-11-16,高铁西九龙,出境,0,0,0,0
2020-11-16,红磡,入境,0,0,0,0
2020-11-16,红磡,出境,0,0,0,0
2020-11-16,罗湖,入境,0,0,0,0
2020-11-16,罗湖,出境,0,0,0,0
2020-11-16,落马洲支线,入境,0,0,0,0
2020-11-16,落马洲支线,出境,0,0,0,0
2020-11-16,香园围,入境,0,0,0,0
2020-11-16,香园围,出境,0,0,0,0
2020-11-16,港珠澳大桥,入境,38,5,2,45
2020-11-16,港珠澳大桥,出境,196,13,4,213
2020-11-16,落马洲,入境,0,0,0,0
2020-11-16,落马洲,出境,0,0,0,0
2020-11-16,文锦渡,入境,0,0,0,0
2020-11-16,文锦渡,出境,0,0,0,0
2020-11-16,沙头角,入境,0,0,0,0
2020-11-16,沙头角,出境,0,0,0,0
2020-11-16,深圳湾,入境,550,91,3,644
2020-11-16,深圳湾,出境,1046,109,0,1155
2020-11-16,中国客运码头,入境,0,0,0,0
2020-11-16,中国客运码头,出境,0,0,0,0
2020-11-16,港口管制,入境,0,0,0,0
2020-11-16,港口管制,出境,0,0,0,0
2020-11-16,启德邮轮码头,入境,0,0,0,0
2020-11-16,启德邮轮码头,出境,0,0,0,0
2020-11-16,港澳客轮码头,入境,0,0,0,0
2020-11-16,港澳客轮码头,出境,0,0,0,0
2020-11-16,屯门客运码头,入境,0,0,0,0
2020-11-16,屯门客运码头,出境,0,0,0,0
2020-11-17,机场,入境,385,4,26,415
2020-11-17,机场,出境,611,14,32,657
2020-11-17,高铁西九龙,入境,0,0,0,0
2020-11-17,高铁西九龙,出境,0,0,0,0
2020-11-17,红磡,入境,0,0,0,0
2020-11-17,红磡,出境,0,0,0,0
2020-11-17,罗湖,入境,0,0,0,0
2020-11-17,罗湖,出境,0,0,0,0
2020-11-17,落马洲支线,入境,0,0,0,0
2020-11-17,落马洲支线,出境,0,0,0,0
2020-11-17,香园围,入境,0,0,0,0
2020-11-17,香园围,出境,0,0,0,0
2020-11-17,港珠澳大桥,入境,21,6,6,33
2020-11-17,港珠澳大桥,出境,213,12,5,230
2020-11-17,落马洲,入境,0,0,0,0
2020-11-17,落马洲,出境,0,0,0,0
2020-11-17,文锦渡,入境,0,0,0,0
2020-11-17,文锦渡,出境,0,0,0,0
2020-11-17,沙头角,入境,0,0,0,0
2020-11-17,沙头角,出境,0,0,0,0
2020-11-17,深圳湾,入境,490,86,3,579
2020-11-17,深圳湾,出境,1340,166,1,1507
2020-11-17,中国客运码头,入境,0,0,0,0
2020-11-17,中国客运码头,出境,0,0,0,0
2020-11-17,港口管制,入境,0,0,0,0
2020-11-17,港口管制,出境,0,0,0,0
2020-11-17,启德邮轮码头,入境,0,0,0,0
2020-11-17,启德邮轮码头,出境,0,0,0,0
2020-11-17,港澳客轮码头,入境,0,0,0,0
2020-11-17,港澳客轮码头,出境,0,0,0,0
2020-11-17,屯门客运码头,入境,0,0,0,0
2020-11-17,屯门客运码头,出境,0,0,0,0
2020-11-18,机场,入境,609,6,27,642
2020-11-18,机场,出境,763,5,86,854
2020-11-18,高铁西九龙,入境,0,0,0,0
2020-11-18,高铁西九龙,出境,0,0,0,0
2020-11-18,红磡,入境,0,0,0,0
2020-11-18,红磡,出境,0,0,0,0
2020-11-18,罗湖,入境,0,0,0,0
2020-11-18,罗湖,出境,0,0,0,0
2020-11-18,落马洲支线,入境,0,0,0,0
2020-11-18,落马洲支线,出境,0,0,0,0
2020-11-18,香园围,入境,0,0,0,0
2020-11-18,香园围,出境,0,0,0,0
2020-11-18,港珠澳大桥,入境,14,3,19,36
2020-11-18,港珠澳大桥,出境,159,10,6,175
2020-11-18,落马洲,入境,0,0,0,0
2020-11-18,落马洲,出境,0,0,0,0
2020-11-18,文锦渡,入境,0,0,0,0
2020-11-18,文锦渡,出境,0,0,0,0
2020-11-18,沙头角,入境,0,0,0,0
2020-11-18,沙头角,出境,0,0,0,0
2020-11-18,深圳湾,入境,407,86,0,493
2020-11-18,深圳湾,出境,1039,156,8,1203
2020-11-18,中国客运码头,入境,0,0,0,0
2020-11-18,中国客运码头,出境,0,0,0,0
2020-11-18,港口管制,入境,0,0,0,0
2020-11-18,港口管制,出境,0,0,0,0
2020-11-18,启德邮轮码头,入境,0,0,0,0
2020-11-18,启德邮轮码头,出境,0,0,0,0
2020-11-18,港澳客轮码头,入境,0,0,0,0
2020-11-18,港澳客轮码头,出境,0,0,0,0
2020-11-18,屯门客运码头,入境,0,0,0,0
2020-11-18,屯门客运码头,出境,0,0,0,0
2020-11-19,机场,入境,568,2,30,600
2020-11-19,机场,出境,550,5,36,591
2020-11-19,高铁西九龙,入境,0,0,0,0
2020-11-19,高铁西九龙,出境,0,0,0,0
2020-11-19,红磡,入境,0,0,0,0
2020-11-19,红磡,出境,0,0,0,0
2020-11-19,罗湖,入境,0,0,0,0
2020-11-19,罗湖,出境,0,0,0,0
2020-11-19,落马洲支线,入境,0,0,0,0
2020-11-19,落马洲支线,出境,0,0,0,0
2020-11-19,香园围,入境,0,0,0,0
2020-11-19,香园围,出境,0,0,0,0
2020-11-19,港珠澳大桥,入境,19,0,3,22
2020-11-19,港珠澳大桥,出境,144,15,6,165
2020-11-19,落马洲,入境,0,0,0,0
2020-11-19,落马洲,出境,0,0,0,0
2020-11-19,文锦渡,入境,0,0,0,0
2020-11-19,文锦渡,出境,0,0,0,0
2020-11-19,沙头角,入境,0,0,0,0
2020-11-19,沙头角,出境,0,0,0,0
2020-11-19,深圳湾,入境,359,95,0,454
2020-11-19,深圳湾,出境,985,128,3,1116
2020-11-19,中国客运码头,入境,0,0,0,0
2020-11-19,中国客运码头,出境,0,0,0,0
2020-11-19,港口管制,入境,0,0,0,0
2020-11-19,港口管制,出境,0,0,0,0
2020-11-19,启德邮轮码头,入境,0,0,0,0
2020-11-19,启德邮轮码头,出境,0,0,0,0
2020-11-19,港澳客轮码头,入境,0,0,0,0
2020-11-19,港澳客轮码头,出境,0,0,0,0
2020-11-19,屯门客运码头,入境,0,0,0,0
2020-11-19,屯门客运码头,出境,0,0,0,0
2020-11-20,机场,入境,766,12,34,812
2020-11-20,机场,出境,976,27,56,1059
2020-11-20,高铁西九龙,入境,0,0,0,0
2020-11-20,高铁西九龙,出境,0,0,0,0
2020-11-20,红磡,入境,0,0,0,0
2020-11-20,红磡,出境,0,0,0,0
2020-11-20,罗湖,入境,0,0,0,0
2020-11-20,罗湖,出境,0,0,0,0
2020-11-20,落马洲支线,入境,0,0,0,0
2020-11-20,落马洲支线,出境,0,0,0,0
2020-11-20,香园围,入境,0,0,0,0
2020-11-20,香园围,出境,0,0,0,0
2020-11-20,港珠澳大桥,入境,22,2,4,28
2020-11-20,港珠澳大桥,出境,178,15,3,196
2020-11-20,落马洲,入境,0,0,0,0
2020-11-20,落马洲,出境,0,0,0,0
2020-11-20,文锦渡,入境,0,0,0,0
2020-11-20,文锦渡,出境,0,0,0,0
2020-11-20,沙头角,入境,0,0,0,0
2020-11-20,沙头角,出境,0,0,0,0
2020-11-20,深圳湾,入境,490,73,1,564
2020-11-20,深圳湾,出境,1073,138,4,1215
2020-11-20,中国客运码头,入境,0,0,0,0
2020-11-20,中国客运码头,出境,0,0,0,0
2020-11-20,港口管制,入境,0,0,0,0
2020-11-20,港口管制,出境,0,0,0,0
2020-11-20,启德邮轮码头,入境,0,0,0,0
2020-11-20,启德邮轮码头,出境,0,0,0,0
2020-11-20,港澳客轮码头,入境,0,0,0,0
2020-11-20,港澳客轮码头,出境,0,0,0,0
2020-11-20,屯门客运码头,入境,0,0,0,0
2020-11-20,屯门客运码头,出境,0,0,0,0
2020-11-21,机场,入境,999,3,41,1043
2020-11-21,机场,出境,957,21,35,1013
2020-11-21,高铁西九龙,入境,0,0,0,0
2020-11-21,高铁西九龙,出境,0,0,0,0
2020-11-21,红磡,入境,0,0,0,0
2020-11-21,红磡,出境,0,0,0,0
2020-11-21,罗湖,入境,0,0,0,0
2020-11-21,罗湖,出境,0,0,0,0
2020-11-21,落马洲支线,入境,0,0,0,0
2020-11-21,落马洲支线,出境,0,0,0,0
2020-11-21,香园围,入境,0,0,0,0
2020-11-21,香园围,出境,0,0,0,0
2020-11-21,港珠澳大桥,入境,22,7,2,31
2020-11-21,港珠澳大桥,出境,151,13,4,168
2020-11-21,落马洲,入境,0,0,0,0
2020-11-21,落马洲,出境,0,0,0,0
2020-11-21,文锦渡,入境,0,0,0,0
2020-11-21,文锦渡,出境,0,0,0,0
2020-11-21,沙头角,入境,0,0,0,0
2020-11-21,沙头角,出境,0,0,0,0
2020-11-21,深圳湾,入境,521,113,3,637
2020-11-21,深圳湾,出境,858,140,4,1002
2020-11-21,中国客运码头,入境,0,0,0,0
2020-11-21,中国客运码头,出境,0,0,0,0
2020-11-21,港口管制,入境,0,0,0,0
2020-11-21,港口管制,出境,0,0,0,0
2020-11-21,启德邮轮码头,入境,0,0,0,0
2020-11-21,启德邮轮码头,出境,0,0,0,0
2020-11-21,港澳客轮码头,入境,0,0,0,0
2020-11-21,港澳客轮码头,出境,0,0,0,0
2020-11-21,屯门客运码头,入境,0,0,0,0
2020-11-21,屯门客运码头,出境,0,0,0,0
2020-11-22,机场,入境,1044,5,27,1076
2020-11-22,机场,出境,904,21,70,995
2020-11-22,高铁西九龙,入境,0,0,0,0
2020-11-22,高铁西九龙,出境,0,0,0,0
2020-11-22,红磡,入境,0,0,0,0
2020-11-22,红磡,出境,0,0,0,0
2020-11-22,罗湖,入境,0,0,0,0
2020-11-22,罗湖,出境,0,0,0,0
2020-11-22,落马洲支线,入境,0,0,0,0
2020-11-22,落马洲支线,出境,0,0,0,0
2020-11-22,香园围,入境,0,0,0,0
2020-11-22,香园围,出境,0,0,0,0
2020-11-22,港珠澳大桥,入境,23,4,5,32
2020-11-22,港珠澳大桥,出境,120,14,2,136
2020-11-22,落马洲,入境,0,0,0,0
2020-11-22,落马洲,出境,0,0,0,0
2020-11-22,文锦渡,入境,0,0,0,0
2020-11-22,文锦渡,出境,0,0,0,0
2020-11-22,沙头角,入境,0,0,0,0
2020-11-22,沙头角,出境,0,0,0,0
2020-11-22,深圳湾,入境,460,93,3,556
2020-11-22,深圳湾,出境,710,123,5,838
2020-11-22,中国客运码头,入境,0,0,0,0
2020-11-22,中国客运码头,出境,0,0,0,0
2020-11-22,港口管制,入境,0,0,0,0
2020-11-22,港口管制,出境,0,0,0,0
2020-11-22,启德邮轮码头,入境,0,0,0,0
2020-11-22,启德邮轮码头,出境,0,0,0,0
2020-11-22,港澳客轮码头,入境,0,0,0,0
2020-11-22,港澳客轮码头,出境,0,0,0,0
2020-11-22,屯门客运码头,入境,0,0,0,0
2020-11-22,屯门客运码头,出境,0,0,0,0
2020-11-23,机场,入境,452,3,14,469
2020-11-23,机场,出境,384,1,36,421
2020-11-23,高铁西九龙,入境,0,0,0,0
2020-11-23,高铁西九龙,出境,0,0,0,0
2020-11-23,红磡,入境,0,0,0,0
2020-11-23,红磡,出境,0,0,0,0
2020-11-23,罗湖,入境,0,0,0,0
2020-11-23,罗湖,出境,0,0,0,0
2020-11-23,落马洲支线,入境,0,0,0,0
2020-11-23,落马洲支线,出境,0,0,0,0
2020-11-23,香园围,入境,0,0,0,0
2020-11-23,香园围,出境,0,0,0,0
2020-11-23,港珠澳大桥,入境,408,2,8,418
2020-11-23,港珠澳大桥,出境,124,12,1,137
2020-11-23,落马洲,入境,0,0,0,0
2020-11-23,落马洲,出境,0,0,0,0
2020-11-23,文锦渡,入境,0,0,0,0
2020-11-23,文锦渡,出境,0,0,0,0
2020-11-23,沙头角,入境,0,0,0,0
2020-11-23,沙头角,出境,0,0,0,0
2020-11-23,深圳湾,入境,2479,97,2,2578
2020-11-23,深圳湾,出境,776,104,1,881
2020-11-23,中国客运码头,入境,0,0,0,0
2020-11-23,中国客运码头,出境,0,0,0,0
2020-11-23,港口管制,入境,0,0,0,0
2020-11-23,港口管制,出境,0,0,0,0
2020-11-23,启德邮轮码头,入境,0,0,0,0
2020-11-23,启德邮轮码头,出境,0,0,0,0
2020-11-23,港澳客轮码头,入境,0,0,0,0
2020-11-23,港澳客轮码头,出境,0,0,0,0
2020-11-23,屯门客运码头,入境,0,0,0,0
2020-11-23,屯门客运码头,出境,0,0,0,0
2020-11-24,机场,入境,386,3,19,408
2020-11-24,机场,出境,781,15,34,830
2020-11-24,高铁西九龙,入境,0,0,0,0
2020-11-24,高铁西九龙,出境,0,0,0,0
2020-11-24,红磡,入境,0,0,0,0
2020-11-24,红磡,出境,0,0,0,0
2020-11-24,罗湖,入境,0,0,0,0
2020-11-24,罗湖,出境,0,0,0,0
2020-11-24,落马洲支线,入境,0,0,0,0
2020-11-24,落马洲支线,出境,0,0,0,0
2020-11-24,香园围,入境,0,0,0,0
2020-11-24,香园围,出境,0,0,0,0
2020-11-24,港珠澳大桥,入境,108,2,4,114
2020-11-24,港珠澳大桥,出境,206,14,8,228
2020-11-24,落马洲,入境,0,0,0,0
2020-11-24,落马洲,出境,0,0,0,0
2020-11-24,文锦渡,入境,0,0,0,0
2020-11-24,文锦渡,出境,0,0,0,0
2020-11-24,沙头角,入境,0,0,0,0
2020-11-24,沙头角,出境,0,0,0,0
2020-11-24,深圳湾,入境,1224,67,2,1293
2020-11-24,深圳湾,出境,1093,172,2,1267
2020-11-24,中国客运码头,入境,0,0,0,0
2020-11-24,中国客运码头,出境,0,0,0,0
2020-11-24,港口管制,入境,0,0,0,0
2020-11-24,港口管制,出境,0,0,0,0
2020-11-24,启德邮轮码头,入境,0,0,0,0
2020-11-24,启德邮轮码头,出境,0,0,0,0
2020-11-24,港澳客轮码头,入境,0,0,0,0
2020-11-24,港澳客轮码头,出境,0,0,0,0
2020-11-24,屯门客运码头,入境,0,0,0,0
2020-11-24,屯门客运码头,出境,0,0,0,0
2020-11-25,机场,入境,520,4,16,540
2020-11-25,机场,出境,625,15,31,671
2020-11-25,高铁西九龙,入境,0,0,0,0
2020-11-25,高铁西九龙,出境,0,0,0,0
2020-11-25,红磡,入境,0,0,0,0
2020-11-25,红磡,出境,0,0,0,0
2020-11-25,罗湖,入境,0,0,0,0
2020-11-25,罗湖,出境,0,0,0,0
2020-11-25,落马洲支线,入境,0,0,0,0
2020-11-25,落马洲支线,出境,0,0,0,0
2020-11-25,香园围,入境,0,0,0,0
2020-11-25,香园围,出境,0,0,0,0
2020-11-25,港珠澳大桥,入境,150,6,5,161
2020-11-25,港珠澳大桥,出境,200,16,4,220
2020-11-25,落马洲,入境,0,0,0,0
2020-11-25,落马洲,出境,0,0,0,0
2020-11-25,文锦渡,入境,0,0,0,0
2020-11-25,文锦渡,出境,0,0,0,0
2020-11-25,沙头角,入境,0,0,0,0
2020-11-25,沙头角,出境,0,0,0,0
2020-11-25,深圳湾,入境,1229,57,6,1292
2020-11-25,深圳湾,出境,1074,187,2,1263
2020-11-25,中国客运码头,入境,0,0,0,0
2020-11-25,中国客运码头,出境,0,0,0,0
2020-11-25,港口管制,入境,0,0,0,0
2020-11-25,港口管制,出境,0,0,0,0
2020-11-25,启德邮轮码头,入境,0,0,0,0
2020-11-25,启德邮轮码头,出境,0,0,0,0
2020-11-25,港澳客轮码头,入境,0,0,0,0
2020-11-25,港澳客轮码头,出境,0,0,0,0
2020-11-25,屯门客运码头,入境,0,0,0,0
2020-11-25,屯门客运码头,出境,0,0,0,0
2020-11-26,机场,入境,708,2,19,729
2020-11-26,机场,出境,651,13,41,705
2020-11-26,高铁西九龙,入境,0,0,0,0
2020-11-26,高铁西九龙,出境,0,0,0,0
2020-11-26,红磡,入境,0,0,0,0
2020-11-26,红磡,出境,0,0,0,0
2020-11-26,罗湖,入境,0,0,0,0
2020-11-26,罗湖,出境,0,0,0,0
2020-11-26,落马洲支线,入境,0,0,0,0
2020-11-26,落马洲支线,出境,0,0,0,0
2020-11-26,香园围,入境,0,0,0,0
2020-11-26,香园围,出境,0,0,0,0
2020-11-26,港珠澳大桥,入境,93,2,6,101
2020-11-26,港珠澳大桥,出境,186,6,3,195
2020-11-26,落马洲,入境,0,0,0,0
2020-11-26,落马洲,出境,0,0,0,0
2020-11-26,文锦渡,入境,0,0,0,0
2020-11-26,文锦渡,出境,0,0,0,0
2020-11-26,沙头角,入境,0,0,0,0
2020-11-26,沙头角,出境,0,0,0,0
2020-11-26,深圳湾,入境,902,76,2,980
2020-11-26,深圳湾,出境,1146,140,10,1296
2020-11-26,中国客运码头,入境,0,0,0,0
2020-11-26,中国客运码头,出境,0,0,0,0
2020-11-26,港口管制,入境,0,0,0,0
2020-11-26,港口管制,出境,0,0,0,0
2020-11-26,启德邮轮码头,入境,0,0,0,0
2020-11-26,启德邮轮码头,出境,0,0,0,0
2020-11-26,港澳客轮码头,入境,0,0,0,0
2020-11-26,港澳客轮码头,出境,0,0,0,0
2020-11-26,屯门客运码头,入境,0,0,0,0
2020-11-26,屯门客运码头,出境,0,0,0,0
2020-11-27,机场,入境,1007,6,28,1041
2020-11-27,机场,出境,1003,24,38,1065
2020-11-27,高铁西九龙,入境,0,0,0,0
2020-11-27,高铁西九龙,出境,0,0,0,0
2020-11-27,红磡,入境,0,0,0,0
2020-11-27,红磡,出境,0,0,0,0
2020-11-27,罗湖,入境,0,0,0,0
2020-11-27,罗湖,出境,0,0,0,0
2020-11-27,落马洲支线,入境,0,0,0,0
2020-11-27,落马洲支线,出境,0,0,0,0
2020-11-27,香园围,入境,0,0,0,0
2020-11-27,香园围,出境,0,0,0,0
2020-11-27,港珠澳大桥,入境,114,3,9,126
2020-11-27,港珠澳大桥,出境,209,8,2,219
2020-11-27,落马洲,入境,0,0,0,0
2020-11-27,落马洲,出境,0,0,0,0
2020-11-27,文锦渡,入境,0,0,0,0
2020-11-27,文锦渡,出境,0,0,0,0
2020-11-27,沙头角,入境,0,0,0,0
2020-11-27,沙头角,出境,0,0,0,0
2020-11-27,深圳湾,入境,859,72,2,933
2020-11-27,深圳湾,出境,1235,170,4,1409
2020-11-27,中国客运码头,入境,0,0,0,0
2020-11-27,中国客运码头,出境,0,0,0,0
2020-11-27,港口管制,入境,0,0,0,0
2020-11-27,港口管制,出境,0,0,0,0
2020-11-27,启德邮轮码头,入境,0,0,0,0
2020-11-27,启德邮轮码头,出境,0,0,0,0
2020-11-27,港澳客轮码头,入境,0,0,0,0
2020-11-27,港澳客轮码头,出境,0,0,0,0
2020-11-27,屯门客运码头,入境,0,0,0,0
2020-11-27,屯门客运码头,出境,0,0,0,0
2020-11-28,机场,入境,1039,9,15,1063
2020-11-28,机场,出境,971,15,46,1032
2020-11-28,高铁西九龙,入境,0,0,0,0
2020-11-28,高铁西九龙,出境,0,0,0,0
2020-11-28,红磡,入境,0,0,0,0
2020-11-28,红磡,出境,0,0,0,0
2020-11-28,罗湖,入境,0,0,0,0
2020-11-28,罗湖,出境,0,0,0,0
2020-11-28,落马洲支线,入境,0,0,0,0
2020-11-28,落马洲支线,出境,0,0,0,0
2020-11-28,香园围,入境,0,0,0,0
2020-11-28,香园围,出境,0,0,0,0
2020-11-28,港珠澳大桥,入境,76,2,1,79
2020-11-28,港珠澳大桥,出境,233,9,5,247
2020-11-28,落马洲,入境,0,0,0,0
2020-11-28,落马洲,出境,0,0,0,0
2020-11-28,文锦渡,入境,0,0,0,0
2020-11-28,文锦渡,出境,0,0,0,0
2020-11-28,沙头角,入境,0,0,0,0
2020-11-28,沙头角,出境,0,0,0,0
2020-11-28,深圳湾,入境,865,75,8,948
2020-11-28,深圳湾,出境,1002,135,3,1140
2020-11-28,中国客运码头,入境,0,0,0,0
2020-11-28,中国客运码头,出境,0,0,0,0
2020-11-28,港口管制,入境,0,0,0,0
2020-11-28,港口管制,出境,0,0,0,0
2020-11-28,启德邮轮码头,入境,0,0,0,0
2020-11-28,启德邮轮码头,出境,0,0,0,0
2020-11-28,港澳客轮码头,入境,0,0,0,0
2020-11-28,港澳客轮码头,出境,0,0,0,0
2020-11-28,屯门客运码头,入境,0,0,0,0
2020-11-28,屯门客运码头,出境,0,0,0,0
2020-11-29,机场,入境,1278,4,33,1315
2020-11-29,机场,出境,1338,15,54,1407
2020-11-29,高铁西九龙,入境,0,0,0,0
2020-11-29,高铁西九龙,出境,0,0,0,0
2020-11-29,红磡,入境,0,0,0,0
2020-11-29,红磡,出境,0,0,0,0
2020-11-29,罗湖,入境,0,0,0,0
2020-11-29,罗湖,出境,0,0,0,0
2020-11-29,落马洲支线,入境,0,0,0,0
2020-11-29,落马洲支线,出境,0,0,0,0
2020-11-29,香园围,入境,0,0,0,0
2020-11-29,香园围,出境,0,0,0,0
2020-11-29,港珠澳大桥,入境,125,4,6,135
2020-11-29,港珠澳大桥,出境,141,11,2,154
2020-11-29,落马洲,入境,0,0,0,0
2020-11-29,落马洲,出境,0,0,0,0
2020-11-29,文锦渡,入境,0,0,0,0
2020-11-29,文锦渡,出境,0,0,0,0
2020-11-29,沙头角,入境,0,0,0,0
2020-11-29,沙头角,出境,0,0,0,0
2020-11-29,深圳湾,入境,1140,88,9,1237
2020-11-29,深圳湾,出境,760,126,5,891
2020-11-29,中国客运码头,入境,0,0,0,0
2020-11-29,中国客运码头,出境,0,0,0,0
2020-11-29,港口管制,入境,0,0,0,0
2020-11-29,港口管制,出境,0,0,0,0
2020-11-29,启德邮轮码头,入境,0,0,0,0
2020-11-29,启德邮轮码头,出境,0,0,0,0
2020-11-29,港澳客轮码头,入境,0,0,0,0
2020-11-29,港澳客轮码头,出境,0,0,0,0
2020-11-29,屯门客运码头,入境,0,0,0,0
2020-11-29,屯门客运码头,出境,0,0,0,0
2020-11-30,机场,入境,787,0,22,809
2020-11-30,机场,出境,679,1,56,736
2020-11-30,高铁西九龙,入境,0,0,0,0
2020-11-30,高铁西九龙,出境,0,0,0,0
2020-11-30,红磡,入境,0,0,0,0
2020-11-30,红磡,出境,0,0,0,0
2020-11-30,罗湖,入境,0,0,0,0
2020-11-30,罗湖,出境,0,0,0,0
2020-11-30,落马洲支线,入境,0,0,0,0
2020-11-30,落马洲支线,出境,0,0,0,0
2020-11-30,香园围,入境,0,0,0,0
2020-11-30,香园围,出境,0,0,0,0
2020-11-30,港珠澳大桥,入境,158,4,2,164
2020-11-30,港珠澳大桥,出境,177,10,0,187
2020-11-30,落马洲,入境,0,0,0,0
2020-11-30,落马洲,出境,0,0,0,0
2020-11-30,文锦渡,入境,0,0,0,0
2020-11-30,文锦渡,出境,0,0,0,0
2020-11-30,沙头角,入境,0,0,0,0
2020-11-30,沙头角,出境,0,0,0,0
2020-11-30,深圳湾,入境,1190,69,1,1260
2020-11-30,深圳湾,出境,914,94,2,1010
2020-11-30,中国客运码头,入境,0,0,0,0
2020-11-30,中国客运码头,出境,0,0,0,0
2020-11-30,港口管制,入境,0,0,0,0
2020-11-30,港口管制,出境,0,0,0,0
2020-11-30,启德邮轮码头,入境,0,0,0,0
2020-11-30,启德邮轮码头,出境,0,0,0,0
2020-11-30,港澳客轮码头,入境,0,0,0,0
2020-11-30,港澳客轮码头,出境,0,0,0,0
2020-11-30,屯门客运码头,入境,0,0,0,0
2020-11-30,屯门客运码头,出境,0,0,0,0
2020-12-01,机场,入境,746,4,21,771
2020-12-01,机场,出境,1344,23,30,1397
2020-12-01,高铁西九龙,入境,0,0,0,0
2020-12-01,高铁西九龙,出境,0,0,0,0
2020-12-01,红磡,入境,0,0,0,0
2020-12-01,红磡,出境,0,0,0,0
2020-12-01,罗湖,入境,0,0,0,0
2020-12-01,罗湖,出境,0,0,0,0
2020-12-01,落马洲支线,入境,0,0,0,0
2020-12-01,落马洲支线,出境,0,0,0,0
2020-12-01,香园围,入境,0,0,0,0
2020-12-01,香园围,出境,0,0,0,0
2020-12-01,港珠澳大桥,入境,80,3,3,86
2020-12-01,港珠澳大桥,出境,279,15,9,303
2020-12-01,落马洲,入境,0,0,0,0
2020-12-01,落马洲,出境,0,0,0,0
2020-12-01,文锦渡,入境,0,0,0,0
2020-12-01,文锦渡,出境,0,0,0,0
2020-12-01,沙头角,入境,0,0,0,0
2020-12-01,沙头角,出境,0,0,0,0
2020-12-01,深圳湾,入境,742,57,2,801
2020-12-01,深圳湾,出境,2704,357,6,3067
2020-12-01,中国客运码头,入境,0,0,0,0
2020-12-01,中国客运码头,出境,0,0,0,0
2020-12-01,港口管制,入境,0,0,0,0
2020-12-01,港口管制,出境,0,0,0,0
2020-12-01,启德邮轮码头,入境,0,0,0,0
2020-12-01,启德邮轮码头,出境,0,0,0,0
2020-12-01,港澳客轮码头,入境,0,0,0,0
2020-12-01,港澳客轮码头,出境,0,0,0,0
2020-12-01,屯门客运码头,入境,0,0,0,0
2020-12-01,屯门客运码头,出境,0,0,0,0
2020-12-02,机场,入境,587,1,28,616
2020-12-02,机场,出境,918,18,55,991
2020-12-02,高铁西九龙,入境,0,0,0,0
2020-12-02,高铁西九龙,出境,0,0,0,0
2020-12-02,红磡,入境,0,0,0,0
2020-12-02,红磡,出境,0,0,0,0
2020-12-02,罗湖,入境,0,0,0,0
2020-12-02,罗湖,出境,0,0,0,0
2020-12-02,落马洲支线,入境,0,0,0,0
2020-12-02,落马洲支线,出境,0,0,0,0
2020-12-02,香园围,入境,0,0,0,0
2020-12-02,香园围,出境,0,0,0,0
2020-12-02,港珠澳大桥,入境,84,2,23,109
2020-12-02,港珠澳大桥,出境,280,18,8,306
2020-12-02,落马洲,入境,0,0,0,0
2020-12-02,落马洲,出境,0,0,0,0
2020-12-02,文锦渡,入境,0,0,0,0
2020-12-02,文锦渡,出境,0,0,0,0
2020-12-02,沙头角,入境,0,0,0,0
2020-12-02,沙头角,出境,0,0,0,0
2020-12-02,深圳湾,入境,676,63,2,741
2020-12-02,深圳湾,出境,3060,436,13,3509
2020-12-02,中国客运码头,入境,0,0,0,0
2020-12-02,中国客运码头,出境,0,0,0,0
2020-12-02,港口管制,入境,0,0,0,0
2020-12-02,港口管制,出境,0,0,0,0
2020-12-02,启德邮轮码头,入境,0,0,0,0
2020-12-02,启德邮轮码头,出境,0,0,0,0
2020-12-02,港澳客轮码头,入境,0,0,0,0
2020-12-02,港澳客轮码头,出境,0,0,0,0
2020-12-02,屯门客运码头,入境,0,0,0,0
2020-12-02,屯门客运码头,出境,0,0,0,0
2020-12-03,机场,入境,841,2,38,881
2020-12-03,机场,出境,919,4,34,957
2020-12-03,高铁西九龙,入境,0,0,0,0
2020-12-03,高铁西九龙,出境,0,0,0,0
2020-12-03,红磡,入境,0,0,0,0
2020-12-03,红磡,出境,0,0,0,0
2020-12-03,罗湖,入境,0,0,0,0
2020-12-03,罗湖,出境,0,0,0,0
2020-12-03,落马洲支线,入境,0,0,0,0
2020-12-03,落马洲支线,出境,0,0,0,0
2020-12-03,香园围,入境,0,0,0,0
2020-12-03,香园围,出境,0,0,0,0
2020-12-03,港珠澳大桥,入境,71,4,2,77
2020-12-03,港珠澳大桥,出境,271,12,11,294
2020-12-03,落马洲,入境,0,0,0,0
2020-12-03,落马洲,出境,0,0,0,0
2020-12-03,文锦渡,入境,0,0,0,0
2020-12-03,文锦渡,出境,0,0,0,0
2020-12-03,沙头角,入境,0,0,0,0
2020-12-03,沙头角,出境,0,0,0,0
2020-12-03,深圳湾,入境,688,56,2,746
2020-12-03,深圳湾,出境,2948,410,10,3368
2020-12-03,中国客运码头,入境,0,0,0,0
2020-12-03,中国客运码头,出境,0,0,0,0
2020-12-03,港口管制,入境,0,0,0,0
2020-12-03,港口管制,出境,0,0,0,0
2020-12-03,启德邮轮码头,入境,0,0,0,0
2020-12-03,启德邮轮码头,出境,0,0,0,0
2020-12-03,港澳客轮码头,入境,0,0,0,0
2020-12-03,港澳客轮码头,出境,0,0,0,0
2020-12-03,屯门客运码头,入境,0,0,0,0
2020-12-03,屯门客运码头,出境,0,0,0,0
2020-12-04,机场,入境,1258,7,34,1299
2020-12-04,机场,出境,1423,23,40,1486
2020-12-04,高铁西九龙,入境,0,0,0,0
2020-12-04,高铁西九龙,出境,0,0,0,0
2020-12-04,红磡,入境,0,0,0,0
2020-12-04,红磡,出境,0,0,0,0
2020-12-04,罗湖,入境,0,0,0,0
2020-12-04,罗湖,出境,0,0,0,0
2020-12-04,落马洲支线,入境,0,0,0,0
2020-12-04,落马洲支线,出境,0,0,0,0
2020-12-04,香园围,入境,0,0,0,0
2020-12-04,香园围,出境,0,0,0,0
2020-12-04,港珠澳大桥,入境,97,8,7,112
2020-12-04,港珠澳大桥,出境,275,16,4,295
2020-12-04,落马洲,入境,0,0,0,0
2020-12-04,落马洲,出境,0,0,0,0
2020-12-04,文锦渡,入境,0,0,0,0
2020-12-04,文锦渡,出境,0,0,0,0
2020-12-04,沙头角,入境,0,0,0,0
2020-12-04,沙头角,出境,0,0,0,0
2020-12-04,深圳湾,入境,518,52,4,574
2020-12-04,深圳湾,出境,2790,371,5,3166
2020-12-04,中国客运码头,入境,0,0,0,0
2020-12-04,中国客运码头,出境,0,0,0,0
2020-12-04,港口管制,入境,0,0,0,0
2020-12-04,港口管制,出境,0,0,0,0
2020-12-04,启德邮轮码头,入境,0,0,0,0
2020-12-04,启德邮轮码头,出境,0,0,0,0
2020-12-04,港澳客轮码头,入境,0,0,0,0
2020-12-04,港澳客轮码头,出境,0,0,0,0
2020-12-04,屯门客运码头,入境,0,0,0,0
2020-12-04,屯门客运码头,出境,0,0,0,0
2020-12-05,机场,入境,922,0,18,940
2020-12-05,机场,出境,1559,30,39,1628
2020-12-05,高铁西九龙,入境,0,0,0,0
2020-12-05,高铁西九龙,出境,0,0,0,0
2020-12-05,红磡,入境,0,0,0,0
2020-12-05,红磡,出境,0,0,0,0
2020-12-05,罗湖,入境,0,0,0,0
2020-12-05,罗湖,出境,0,0,0,0
2020-12-05,落马洲支线,入境,0,0,0,0
2020-12-05,落马洲支线,出境,0,0,0,0
2020-12-05,香园围,入境,0,0,0,0
2020-12-05,香园围,出境,0,0,0,0
2020-12-05,港珠澳大桥,入境,63,3,2,68
2020-12-05,港珠澳大桥,出境,297,12,7,316
2020-12-05,落马洲,入境,0,0,0,0
2020-12-05,落马洲,出境,0,0,0,0
2020-12-05,文锦渡,入境,0,0,0,0
2020-12-05,文锦渡,出境,0,0,0,0
2020-12-05,沙头角,入境,0,0,0,0
2020-12-05,沙头角,出境,0,0,0,0
2020-12-05,深圳湾,入境,623,80,4,707
2020-12-05,深圳湾,出境,2554,314,6,2874
2020-12-05,中国客运码头,入境,0,0,0,0
2020-12-05,中国客运码头,出境,0,0,0,0
2020-12-05,港口管制,入境,0,0,0,0
2020-12-05,港口管制,出境,0,0,0,0
2020-12-05,启德邮轮码头,入境,0,0,0,0
2020-12-05,启德邮轮码头,出境,0,0,0,0
2020-12-05,港澳客轮码头,入境,0,0,0,0
2020-12-05,港澳客轮码头,出境,0,0,0,0
2020-12-05,屯门客运码头,入境,0,0,0,0
2020-12-05,屯门客运码头,出境,0,0,0,0
2020-12-06,机场,入境,1837,6,40,1883
2020-12-06,机场,出境,1407,24,55,1486
2020-12-06,高铁西九龙,入境,0,0,0,0
2020-12-06,高铁西九龙,出境,0,0,0,0
2020-12-06,红磡,入境,0,0,0,0
2020-12-06,红磡,出境,0,0,0,0
2020-12-06,罗湖,入境,0,0,0,0
2020-12-06,罗湖,出境,0,0,0,0
2020-12-06,落马洲支线,入境,0,0,0,0
2020-12-06,落马洲支线,出境,0,0,0,0
2020-12-06,香园围,入境,0,0,0,0
2020-12-06,香园围,出境,0,0,0,0
2020-12-06,港珠澳大桥,入境,68,2,2,72
2020-12-06,港珠澳大桥,出境,258,17,3,278
2020-12-06,落马洲,入境,0,0,0,0
2020-12-06,落马洲,出境,0,0,0,0
2020-12-06,文锦渡,入境,0,0,0,0
2020-12-06,文锦渡,出境,0,0,0,0
2020-12-06,沙头角,入境,0,0,0,0
2020-12-06,沙头角,出境,0,0,0,0
2020-12-06,深圳湾,入境,616,79,2,697
2020-12-06,深圳湾,出境,1761,205,0,1966
2020-12-06,中国客运码头,入境,0,0,0,0
2020-12-06,中国客运码头,出境,0,0,0,0
2020-12-06,港口管制,入境,0,0,0,0
2020-12-06,港口管制,出境,0,0,0,0
2020-12-06,启德邮轮码头,入境,0,0,0,0
2020-12-06,启德邮轮码头,出境,0,0,0,0
2020-12-06,港澳客轮码头,入境,0,0,0,0
2020-12-06,港澳客轮码头,出境,0,0,0,0
2020-12-06,屯门客运码头,入境,0,0,0,0
2020-12-06,屯门客运码头,出境,0,0,0,0
2020-12-07,机场,入境,1470,2,64,1536
2020-12-07,机场,出境,839,9,30,878
2020-12-07,高铁西九龙,入境,0,0,0,0
2020-12-07,高铁西九龙,出境,0,0,0,0
2020-12-07,红磡,入境,0,0,0,0
2020-12-07,红磡,出境,0,0,0,0
2020-12-07,罗湖,入境,0,0,0,0
2020-12-07,罗湖,出境,0,0,0,0
2020-12-07,落马洲支线,入境,0,0,0,0
2020-12-07,落马洲支线,出境,0,0,0,0
2020-12-07,香园围,入境,0,0,0,0
2020-12-07,香园围,出境,0,0,0,0
2020-12-07,港珠澳大桥,入境,157,8,9,174
2020-12-07,港珠澳大桥,出境,255,16,4,275
2020-12-07,落马洲,入境,0,0,0,0
2020-12-07,落马洲,出境,0,0,0,0
2020-12-07,文锦渡,入境,0,0,0,0
2020-12-07,文锦渡,出境,0,0,0,0
2020-12-07,沙头角,入境,0,0,0,0
2020-12-07,沙头角,出境,0,0,0,0
2020-12-07,深圳湾,入境,1023,63,2,1088
2020-12-07,深圳湾,出境,1354,133,3,1490
2020-12-07,中国客运码头,入境,0,0,0,0
2020-12-07,中国客运码头,出境,0,0,0,0
2020-12-07,港口管制,入境,0,0,0,0
2020-12-07,港口管制,出境,0,0,0,0
2020-12-07,启德邮轮码头,入境,0,0,0,0
2020-12-07,启德邮轮码头,出境,0,0,0,0
2020-12-07,港澳客轮码头,入境,0,0,0,0
2020-12-07,港澳客轮码头,出境,0,0,0,0
2020-12-07,屯门客运码头,入境,0,0,0,0
2020-12-07,屯门客运码头,出境,0,0,0,0
2020-12-08,机场,入境,823,4,20,847
2020-12-08,机场,出境,1444,30,45,1519
2020-12-08,高铁西九龙,入境,0,0,0,0
2020-12-08,高铁西九龙,出境,0,0,0,0
2020-12-08,红磡,入境,0,0,0,0
2020-12-08,红磡,出境,0,0,0,0
2020-12-08,罗湖,入境,0,0,0,0
2020-12-08,罗湖,出境,0,0,0,0
2020-12-08,落马洲支线,入境,0,0,0,0
2020-12-08,落马洲支线,出境,0,0,0,0
2020-12-08,香园围,入境,0,0,0,0
2020-12-08,香园围,出境,0,0,0,0
2020-12-08,港珠澳大桥,入境,73,2,6,81
2020-12-08,港珠澳大桥,出境,299,8,1,308
2020-12-08,落马洲,入境,0,0,0,0
2020-12-08,落马洲,出境,0,0,0,0
2020-12-08,文锦渡,入境,0,0,0,0
2020-12-08,文锦渡,出境,0,0,0,0
2020-12-08,沙头角,入境,0,0,0,0
2020-12-08,沙头角,出境,0,0,0,0
2020-12-08,深圳湾,入境,708,64,4,776
2020-12-08,深圳湾,出境,1834,197,7,2038
2020-12-08,中国客运码头,入境,0,0,0,0
2020-12-08,中国客运码头,出境,0,0,0,0
2020-12-08,港口管制,入境,0,0,0,0
2020-12-08,港口管制,出境,0,0,0,0
2020-12-08,启德邮轮码头,入境,0,0,0,0
2020-12-08,启德邮轮码头,出境,0,0,0,0
2020-12-08,港澳客轮码头,入境,0,0,0,0
2020-12-08,港澳客轮码头,出境,0,0,0,0
2020-12-08,屯门客运码头,入境,0,0,0,0
2020-12-08,屯门客运码头,出境,0,0,0,0
2020-12-09,机场,入境,899,1,43,943
2020-12-09,机场,出境,1108,10,73,1191
2020-12-09,高铁西九龙,入境,0,0,0,0
2020-12-09,高铁西九龙,出境,0,0,0,0
2020-12-09,红磡,入境,0,0,0,0
2020-12-09,红磡,出境,0,0,0,0
2020-12-09,罗湖,入境,0,0,0,0
2020-12-09,罗湖,出境,0,0,0,0
2020-12-09,落马洲支线,入境,0,0,0,0
2020-12-09,落马洲支线,出境,0,0,0,0
2020-12-09,香园围,入境,0,0,0,0
2020-12-09,香园围,出境,0,0,0,0
2020-12-09,港珠澳大桥,入境,72,1,7,80
2020-12-09,港珠澳大桥,出境,310,14,3,327
2020-12-09,落马洲,入境,0,0,0,0
2020-12-09,落马洲,出境,0,0,0,0
2020-12-09,文锦渡,入境,0,0,0,0
2020-12-09,文锦渡,出境,0,0,0,0
2020-12-09,沙头角,入境,0,0,0,0
2020-12-09,沙头角,出境,0,0,0,0
2020-12-09,深圳湾,入境,610,58,3,671
2020-12-09,深圳湾,出境,1865,182,1,2048
2020-12-09,中国客运码头,入境,0,0,0,0
2020-12-09,中国客运码头,出境,0,0,0,0
2020-12-09,港口管制,入境,0,0,0,0
2020-12-09,港口管制,出境,0,0,0,0
2020-12-09,启德邮轮码头,入境,0,0,0,0
2020-12-09,启德邮轮码头,出境,0,0,0,0
2020-12-09,港澳客轮码头,入境,0,0,0,0
2020-12-09,港澳客轮码头,出境,0,0,0,0
2020-12-09,屯门客运码头,入境,0,0,0,0
2020-12-09,屯门客运码头,出境,0,0,0,0
2020-12-10,机场,入境,793,3,39,835
2020-12-10,机场,出境,1307,10,142,1459
2020-12-10,高铁西九龙,入境,0,0,0,0
2020-12-10,高铁西九龙,出境,0,0,0,0
2020-12-10,红磡,入境,0,0,0,0
2020-12-10,红磡,出境,0,0,0,0
2020-12-10,罗湖,入境,0,0,0,0
2020-12-10,罗湖,出境,0,0,0,0
2020-12-10,落马洲支线,入境,0,0,0,0
2020-12-10,落马洲支线,出境,0,0,0,0
2020-12-10,香园围,入境,0,0,0,0
2020-12-10,香园围,出境,0,0,0,0
2020-12-10,港珠澳大桥,入境,74,2,87,163
2020-12-10,港珠澳大桥,出境,294,9,6,309
2020-12-10,落马洲,入境,0,0,0,0
2020-12-10,落马洲,出境,0,0,0,0
2020-12-10,文锦渡,入境,0,0,0,0
2020-12-10,文锦渡,出境,0,0,0,0
2020-12-10,沙头角,入境,0,0,0,0
2020-12-10,沙头角,出境,0,0,0,0
2020-12-10,深圳湾,入境,606,69,3,678
2020-12-10,深圳湾,出境,1978,220,2,2200
2020-12-10,中国客运码头,入境,0,0,0,0
2020-12-10,中国客运码头,出境,0,0,0,0
2020-12-10,港口管制,入境,0,0,0,0
2020-12-10,港口管制,出境,0,0,0,0
2020-12-10,启德邮轮码头,入境,0,0,0,0
2020-12-10,启德邮轮码头,出境,0,0,0,0
2020-12-10,港澳客轮码头,入境,0,0,0,0
2020-12-10,港澳客轮码头,出境,0,0,0,0
2020-12-10,屯门客运码头,入境,0,0,0,0
2020-12-10,屯门客运码头,出境,0,0,0,0
2020-12-11,机场,入境,1050,2,57,1109
2020-12-11,机场,出境,1514,22,45,1581
2020-12-11,高铁西九龙,入境,0,0,0,0
2020-12-11,高铁西九龙,出境,0,0,0,0
2020-12-11,红磡,入境,0,0,0,0
2020-12-11,红磡,出境,0,0,0,0
2020-12-11,罗湖,入境,0,0,0,0
2020-12-11,罗湖,出境,0,0,0,0
2020-12-11,落马洲支线,入境,0,0,0,0
2020-12-11,落马洲支线,出境,0,0,0,0
2020-12-11,香园围,入境,0,0,0,0
2020-12-11,香园围,出境,0,0,0,0
2020-12-11,港珠澳大桥,入境,105,3,7,115
2020-12-11,港珠澳大桥,出境,262,9,4,275
2020-12-11,落马洲,入境,0,0,0,0
2020-12-11,落马洲,出境,0,0,0,0
2020-12-11,文锦渡,入境,0,0,0,0
2020-12-11,文锦渡,出境,0,0,0,0
2020-12-11,沙头角,入境,0,0,0,0
2020-12-11,沙头角,出境,0,0,0,0
2020-12-11,深圳湾,入境,524,52,3,579
2020-12-11,深圳湾,出境,2134,228,5,2367
2020-12-11,中国客运码头,入境,0,0,0,0
2020-12-11,中国客运码头,出境,0,0,0,0
2020-12-11,港口管制,入境,0,0,0,0
2020-12-11,港口管制,出境,0,0,0,0
2020-12-11,启德邮轮码头,入境,0,0,0,0
2020-12-11,启德邮轮码头,出境,0,0,0,0
2020-12-11,港澳客轮码头,入境,0,0,0,0
2020-12-11,港澳客轮码头,出境,0,0,0,0
2020-12-11,屯门客运码头,入境,0,0,0,0
2020-12-11,屯门客运码头,出境,0,0,0,0
2020-12-12,机场,入境,543,4,13,560
2020-12-12,机场,出境,1558,17,27,1602
2020-12-12,高铁西九龙,入境,0,0,0,0
2020-12-12,高铁西九龙,出境,0,0,0,0
2020-12-12,红磡,入境,0,0,0,0
2020-12-12,红磡,出境,0,0,0,0
2020-12-12,罗湖,入境,0,0,0,0
2020-12-12,罗湖,出境,0,0,0,0
2020-12-12,落马洲支线,入境,0,0,0,0
2020-12-12,落马洲支线,出境,0,0,0,0
2020-12-12,香园围,入境,0,0,0,0
2020-12-12,香园围,出境,0,0,0,0
2020-12-12,港珠澳大桥,入境,61,3,5,69
2020-12-12,港珠澳大桥,出境,267,14,5,286
2020-12-12,落马洲,入境,0,0,0,0
2020-12-12,落马洲,出境,0,0,0,0
2020-12-12,文锦渡,入境,0,0,0,0
2020-12-12,文锦渡,出境,0,0,0,0
2020-12-12,沙头角,入境,0,0,0,0
2020-12-12,沙头角,出境,0,0,0,0
2020-12-12,深圳湾,入境,494,63,5,562
2020-12-12,深圳湾,出境,1994,219,3,2216
2020-12-12,中国客运码头,入境,0,0,0,0
2020-12-12,中国客运码头,出境,0,0,0,0
2020-12-12,港口管制,入境,0,0,0,0
2020-12-12,港口管制,出境,0,0,0,0
2020-12-12,启德邮轮码头,入境,0,0,0,0
2020-12-12,启德邮轮码头,出境,0,0,0,0
2020-12-12,港澳客轮码头,入境,0,0,0,0
2020-12-12,港澳客轮码头,出境,0,0,0,0
2020-12-12,屯门客运码头,入境,0,0,0,0
2020-12-12,屯门客运码头,出境,0,0,0,0
2020-12-13,机场,入境,1012,2,37,1051
2020-12-13,机场,出境,1490,28,50,1568
2020-12-13,高铁西九龙,入境,0,0,0,0
2020-12-13,高铁西九龙,出境,0,0,0,0
2020-12-13,红磡,入境,0,0,0,0
2020-12-13,红磡,出境,0,0,0,0
2020-12-13,罗湖,入境,0,0,0,0
2020-12-13,罗湖,出境,0,0,0,0
2020-12-13,落马洲支线,入境,0,0,0,0
2020-12-13,落马洲支线,出境,0,0,0,0
2020-12-13,香园围,入境,0,0,0,0
2020-12-13,香园围,出境,0,0,0,0
2020-12-13,港珠澳大桥,入境,33,3,4,40
2020-12-13,港珠澳大桥,出境,304,18,5,327
2020-12-13,落马洲,入境,0,0,0,0
2020-12-13,落马洲,出境,0,0,0,0
2020-12-13,文锦渡,入境,0,0,0,0
2020-12-13,文锦渡,出境,0,0,0,0
2020-12-13,沙头角,入境,0,0,0,0
2020-12-13,沙头角,出境,0,0,0,0
2020-12-13,深圳湾,入境,513,58,1,572
2020-12-13,深圳湾,出境,1426,167,1,1594
2020-12-13,中国客运码头,入境,0,0,0,0
2020-12-13,中国客运码头,出境,0,0,0,0
2020-12-13,港口管制,入境,0,0,0,0
2020-12-13,港口管制,出境,0,0,0,0
2020-12-13,启德邮轮码头,入境,0,0,0,0
2020-12-13,启德邮轮码头,出境,0,0,0,0
2020-12-13,港澳客轮码头,入境,0,0,0,0
2020-12-13,港澳客轮码头,出境,0,0,0,0
2020-12-13,屯门客运码头,入境,0,0,0,0
2020-12-13,屯门客运码头,出境,0,0,0,0
2020-12-14,机场,入境,318,4,21,343
2020-12-14,机场,出境,873,15,67,955
2020-12-14,高铁西九龙,入境,0,0,0,0
2020-12-14,高铁西九龙,出境,0,0,0,0
2020-12-14,红磡,入境,0,0,0,0
2020-12-14,红磡,出境,0,0,0,0
2020-12-14,罗湖,入境,0,0,0,0
2020-12-14,罗湖,出境,0,0,0,0
2020-12-14,落马洲支线,入境,0,0,0,0
2020-12-14,落马洲支线,出境,0,0,0,0
2020-12-14,香园围,入境,0,0,0,0
2020-12-14,香园围,出境,0,0,0,0
2020-12-14,港珠澳大桥,入境,151,9,5,165
2020-12-14,港珠澳大桥,出境,224,15,1,240
2020-12-14,落马洲,入境,0,0,0,0
2020-12-14,落马洲,出境,0,0,0,0
2020-12-14,文锦渡,入境,0,0,0,0
2020-12-14,文锦渡,出境,0,0,0,0
2020-12-14,沙头角,入境,0,0,0,0
2020-12-14,沙头角,出境,0,0,0,0
2020-12-14,深圳湾,入境,984,60,1,1045
2020-12-14,深圳湾,出境,1315,129,2,1446
2020-12-14,中国客运码头,入境,0,0,0,0
2020-12-14,中国客运码头,出境,0,0,0,0
2020-12-14,港口管制,入境,0,0,0,0
2020-12-14,港口管制,出境,0,0,0,0
2020-12-14,启德邮轮码头,入境,0,0,0,0
2020-12-14,启德邮轮码头,出境,0,0,0,0
2020-12-14,港澳客轮码头,入境,0,0,0,0
2020-12-14,港澳客轮码头,出境,0,0,0,0
2020-12-14,屯门客运码头,入境,0,0,0,0
2020-12-14,屯门客运码头,出境,0,0,0,0
2020-12-15,机场,入境,531,10,28,569
2020-12-15,机场,出境,1440,38,41,1519
2020-12-15,高铁西九龙,入境,0,0,0,0
2020-12-15,高铁西九龙,出境,0,0,0,0
2020-12-15,红磡,入境,0,0,0,0
2020-12-15,红磡,出境,0,0,0,0
2020-12-15,罗湖,入境,0,0,0,0
2020-12-15,罗湖,出境,0,0,0,0
2020-12-15,落马洲支线,入境,0,0,0,0
2020-12-15,落马洲支线,出境,0,0,0,0
2020-12-15,香园围,入境,0,0,0,0
2020-12-15,香园围,出境,0,0,0,0
2020-12-15,港珠澳大桥,入境,83,5,5,93
2020-12-15,港珠澳大桥,出境,260,17,6,283
2020-12-15,落马洲,入境,0,0,0,0
2020-12-15,落马洲,出境,0,0,0,0
2020-12-15,文锦渡,入境,0,0,0,0
2020-12-15,文锦渡,出境,0,0,0,0
2020-12-15,沙头角,入境,0,0,0,0
2020-12-15,沙头角,出境,0,0,0,0
2020-12-15,深圳湾,入境,668,71,1,740
2020-12-15,深圳湾,出境,2015,192,6,2213
2020-12-15,中国客运码头,入境,0,0,0,0
2020-12-15,中国客运码头,出境,0,0,0,0
2020-12-15,港口管制,入境,0,0,0,0
2020-12-15,港口管制,出境,0,0,0,0
2020-12-15,启德邮轮码头,入境,0,0,0,0
2020-12-15,启德邮轮码头,出境,0,0,0,0
2020-12-15,港澳客轮码头,入境,0,0,0,0
2020-12-15,港澳客轮码头,出境,0,0,0,0
2020-12-15,屯门客运码头,入境,0,0,0,0
2020-12-15,屯门客运码头,出境,0,0,0,0
2020-12-16,机场,入境,509,5,24,538
2020-12-16,机场,出境,1131,12,50,1193
2020-12-16,高铁西九龙,入境,0,0,0,0
2020-12-16,高铁西九龙,出境,0,0,0,0
2020-12-16,红磡,入境,0,0,0,0
2020-12-16,红磡,出境,0,0,0,0
2020-12-16,罗湖,入境,0,0,0,0
2020-12-16,罗湖,出境,0,0,0,0
2020-12-16,落马洲支线,入境,0,0,0,0
2020-12-16,落马洲支线,出境,0,0,0,0
2020-12-16,香园围,入境,0,0,0,0
2020-12-16,香园围,出境,0,0,0,0
2020-12-16,港珠澳大桥,入境,107,2,17,126
2020-12-16,港珠澳大桥,出境,246,14,2,262
2020-12-16,落马洲,入境,0,0,0,0
2020-12-16,落马洲,出境,0,0,0,0
2020-12-16,文锦渡,入境,0,0,0,0
2020-12-16,文锦渡,出境,0,0,0,0
2020-12-16,沙头角,入境,0,0,0,0
2020-12-16,沙头角,出境,0,0,0,0
2020-12-16,深圳湾,入境,693,60,1,754
2020-12-16,深圳湾,出境,2042,222,3,2267
2020-12-16,中国客运码头,入境,0,0,0,0
2020-12-16,中国客运码头,出境,0,0,0,0
2020-12-16,港口管制,入境,0,0,0,0
2020-12-16,港口管制,出境,0,0,0,0
2020-12-16,启德邮轮码头,入境,0,0,0,0
2020-12-16,启德邮轮码头,出境,0,0,0,0
2020-12-16,港澳客轮码头,入境,0,0,0,0
2020-12-16,港澳客轮码头,出境,0,0,0,0
2020-12-16,屯门客运码头,入境,0,0,0,0
2020-12-16,屯门客运码头,出境,0,0,0,0
2020-12-17,机场,入境,622,1,31,654
2020-12-17,机场,出境,1224,10,58,1292
2020-12-17,高铁西九龙,入境,0,0,0,0
2020-12-17,高铁西九龙,出境,0,0,0,0
2020-12-17,红磡,入境,0,0,0,0
2020-12-17,红磡,出境,0,0,0,0
2020-12-17,罗湖,入境,0,0,0,0
2020-12-17,罗湖,出境,0,0,0,0
2020-12-17,落马洲支线,入境,0,0,0,0
2020-12-17,落马洲支线,出境,0,0,0,0
2020-12-17,香园围,入境,0,0,0,0
2020-12-17,香园围,出境,0,0,0,0
2020-12-17,港珠澳大桥,入境,122,2,4,128
2020-12-17,港珠澳大桥,出境,257,16,0,273
2020-12-17,落马洲,入境,0,0,0,0
2020-12-17,落马洲,出境,0,0,0,0
2020-12-17,文锦渡,入境,0,0,0,0
2020-12-17,文锦渡,出境,0,0,0,0
2020-12-17,沙头角,入境,0,0,0,0
2020-12-17,沙头角,出境,0,0,0,0
2020-12-17,深圳湾,入境,535,48,1,584
2020-12-17,深圳湾,出境,1687,190,1,1878
2020-12-17,中国客运码头,入境,0,0,0,0
2020-12-17,中国客运码头,出境,0,0,0,0
2020-12-17,港口管制,入境,0,0,0,0
2020-12-17,港口管制,出境,0,0,0,0
2020-12-17,启德邮轮码头,入境,0,0,0,0
2020-12-17,启德邮轮码头,出境,0,0,0,0
2020-12-17,港澳客轮码头,入境,0,0,0,0
2020-12-17,港澳客轮码头,出境,0,0,0,0
2020-12-17,屯门客运码头,入境,0,0,0,0
2020-12-17,屯门客运码头,出境,0,0,0,0
2020-12-18,机场,入境,775,7,27,809
2020-12-18,机场,出境,1514,25,50,1589
2020-12-18,高铁西九龙,入境,0,0,0,0
2020-12-18,高铁西九龙,出境,0,0,0,0
2020-12-18,红磡,入境,0,0,0,0
2020-12-18,红磡,出境,0,0,0,0
2020-12-18,罗湖,入境,0,0,0,0
2020-12-18,罗湖,出境,0,0,0,0
2020-12-18,落马洲支线,入境,0,0,0,0
2020-12-18,落马洲支线,出境,0,0,0,0
2020-12-18,香园围,入境,0,0,0,0
2020-12-18,香园围,出境,0,0,0,0
2020-12-18,港珠澳大桥,入境,191,3,9,203
2020-12-18,港珠澳大桥,出境,259,5,1,265
2020-12-18,落马洲,入境,0,0,0,0
2020-12-18,落马洲,出境,0,0,0,0
2020-12-18,文锦渡,入境,0,0,0,0
2020-12-18,文锦渡,出境,0,0,0,0
2020-12-18,沙头角,入境,0,0,0,0
2020-12-18,沙头角,出境,0,0,0,0
2020-12-18,深圳湾,入境,886,68,3,957
2020-12-18,深圳湾,出境,1511,173,4,1688
2020-12-18,中国客运码头,入境,0,0,0,0
2020-12-18,中国客运码头,出境,0,0,0,0
2020-12-18,港口管制,入境,0,0,0,0
2020-12-18,港口管制,出境,0,0,0,0
2020-12-18,启德邮轮码头,入境,0,0,0,0
2020-12-18,启德邮轮码头,出境,0,0,0,0
2020-12-18,港澳客轮码头,入境,0,0,0,0
2020-12-18,港澳客轮码头,出境,0,0,0,0
2020-12-18,屯门客运码头,入境,0,0,0,0
2020-12-18,屯门客运码头,出境,0,0,0,0
2020-12-19,机场,入境,678,3,16,697
2020-12-19,机场,出境,1474,14,40,1528
2020-12-19,高铁西九龙,入境,0,0,0,0
2020-12-19,高铁西九龙,出境,0,0,0,0
2020-12-19,红磡,入境,0,0,0,0
2020-12-19,红磡,出境,0,0,0,0
2020-12-19,罗湖,入境,0,0,0,0
2020-12-19,罗湖,出境,0,0,0,0
2020-12-19,落马洲支线,入境,0,0,0,0
2020-12-19,落马洲支线,出境,0,0,0,0
2020-12-19,香园围,入境,0,0,0,0
2020-12-19,香园围,出境,0,0,0,0
2020-12-19,港珠澳大桥,入境,119,0,4,123
2020-12-19,港珠澳大桥,出境,221,18,4,243
2020-12-19,落马洲,入境,0,0,0,0
2020-12-19,落马洲,出境,0,0,0,0
2020-12-19,文锦渡,入境,0,0,0,0
2020-12-19,文锦渡,出境,0,0,0,0
2020-12-19,沙头角,入境,0,0,0,0
2020-12-19,沙头角,出境,0,0,0,0
2020-12-19,深圳湾,入境,649,55,2,706
2020-12-19,深圳湾,出境,1415,162,2,1579
2020-12-19,中国客运码头,入境,0,0,0,0
2020-12-19,中国客运码头,出境,0,0,0,0
2020-12-19,港口管制,入境,0,0,0,0
2020-12-19,港口管制,出境,0,0,0,0
2020-12-19,启德邮轮码头,入境,0,0,0,0
2020-12-19,启德邮轮码头,出境,0,0,0,0
2020-12-19,港澳客轮码头,入境,0,0,0,0
2020-12-19,港澳客轮码头,出境,0,0,0,0
2020-12-19,屯门客运码头,入境,0,0,0,0
2020-12-19,屯门客运码头,出境,0,0,0,0
2020-12-20,机场,入境,1088,6,39,1133
2020-12-20,机场,出境,1280,28,50,1358
2020-12-20,高铁西九龙,入境,0,0,0,0
2020-12-20,高铁西九龙,出境,0,0,0,0
2020-12-20,红磡,入境,0,0,0,0
2020-12-20,红磡,出境,0,0,0,0
2020-12-20,罗湖,入境,0,0,0,0
2020-12-20,罗湖,出境,0,0,0,0
2020-12-20,落马洲支线,入境,0,0,0,0
2020-12-20,落马洲支线,出境,0,0,0,0
2020-12-20,香园围,入境,0,0,0,0
2020-12-20,香园围,出境,0,0,0,0
2020-12-20,港珠澳大桥,入境,89,2,3,94
2020-12-20,港珠澳大桥,出境,236,19,4,259
2020-12-20,落马洲,入境,0,0,0,0
2020-12-20,落马洲,出境,0,0,0,0
2020-12-20,文锦渡,入境,0,0,0,0
2020-12-20,文锦渡,出境,0,0,0,0
2020-12-20,沙头角,入境,0,0,0,0
2020-12-20,沙头角,出境,0,0,0,0
2020-12-20,深圳湾,入境,630,73,3,706
2020-12-20,深圳湾,出境,1000,119,3,1122
2020-12-20,中国客运码头,入境,0,0,0,0
2020-12-20,中国客运码头,出境,0,0,0,0
2020-12-20,港口管制,入境,0,0,0,0
2020-12-20,港口管制,出境,0,0,0,0
2020-12-20,启德邮轮码头,入境,0,0,0,0
2020-12-20,启德邮轮码头,出境,0,0,0,0
2020-12-20,港澳客轮码头,入境,0,0,0,0
2020-12-20,港澳客轮码头,出境,0,0,0,0
2020-12-20,屯门客运码头,入境,0,0,0,0
2020-12-20,屯门客运码头,出境,0,0,0,0
2020-12-21,机场,入境,231,3,16,250
2020-12-21,机场,出境,680,14,25,719
2020-12-21,高铁西九龙,入境,0,0,0,0
2020-12-21,高铁西九龙,出境,0,0,0,0
2020-12-21,红磡,入境,0,0,0,0
2020-12-21,红磡,出境,0,0,0,0
2020-12-21,罗湖,入境,0,0,0,0
2020-12-21,罗湖,出境,0,0,0,0
2020-12-21,落马洲支线,入境,0,0,0,0
2020-12-21,落马洲支线,出境,0,0,0,0
2020-12-21,香园围,入境,0,0,0,0
2020-12-21,香园围,出境,0,0,0,0
2020-12-21,港珠澳大桥,入境,198,3,4,205
2020-12-21,港珠澳大桥,出境,238,8,3,249
2020-12-21,落马洲,入境,0,0,0,0
2020-12-21,落马洲,出境,0,0,0,0
2020-12-21,文锦渡,入境,0,0,0,0
2020-12-21,文锦渡,出境,0,0,0,0
2020-12-21,沙头角,入境,0,0,0,0
2020-12-21,沙头角,出境,0,0,0,0
2020-12-21,深圳湾,入境,1181,60,1,1242
2020-12-21,深圳湾,出境,872,88,3,963
2020-12-21,中国客运码头,入境,0,0,0,0
2020-12-21,中国客运码头,出境,0,0,0,0
2020-12-21,港口管制,入境,0,0,0,0
2020-12-21,港口管制,出境,0,0,0,0
2020-12-21,启德邮轮码头,入境,0,0,0,0
2020-12-21,启德邮轮码头,出境,0,0,0,0
2020-12-21,港澳客轮码头,入境,0,0,0,0
2020-12-21,港澳客轮码头,出境,0,0,0,0
2020-12-21,屯门客运码头,入境,0,0,0,0
2020-12-21,屯门客运码头,出境,0,0,0,0
2020-12-22,机场,入境,602,3,21,626
2020-12-22,机场,出境,1059,23,24,1106
2020-12-22,高铁西九龙,入境,0,0,0,0
2020-12-22,高铁西九龙,出境,0,0,0,0
2020-12-22,红磡,入境,0,0,0,0
2020-12-22,红磡,出境,0,0,0,0
2020-12-22,罗湖,入境,0,0,0,0
2020-12-22,罗湖,出境,0,0,0,0
2020-12-22,落马洲支线,入境,0,0,0,0
2020-12-22,落马洲支线,出境,0,0,0,0
2020-12-22,香园围,入境,0,0,0,0
2020-12-22,香园围,出境,0,0,0,0
2020-12-22,港珠澳大桥,入境,70,6,8,84
2020-12-22,港珠澳大桥,出境,277,7,7,291
2020-12-22,落马洲,入境,0,0,0,0
2020-12-22,落马洲,出境,0,0,0,0
2020-12-22,文锦渡,入境,0,0,0,0
2020-12-22,文锦渡,出境,0,0,0,0
2020-12-22,沙头角,入境,0,0,0,0
2020-12-22,沙头角,出境,0,0,0,0
2020-12-22,深圳湾,入境,1161,59,3,1223
2020-12-22,深圳湾,出境,2040,201,5,2246
2020-12-22,中国客运码头,入境,0,0,0,0
2020-12-22,中国客运码头,出境,0,0,0,0
2020-12-22,港口管制,入境,0,0,0,0
2020-12-22,港口管制,出境,0,0,0,0
2020-12-22,启德邮轮码头,入境,0,0,0,0
2020-12-22,启德邮轮码头,出境,0,0,0,0
2020-12-22,港澳客轮码头,入境,0,0,0,0
2020-12-22,港澳客轮码头,出境,0,0,0,0
2020-12-22,屯门客运码头,入境,0,0,0,0
2020-12-22,屯门客运码头,出境,0,0,0,0
2020-12-23,机场,入境,371,7,9,387
2020-12-23,机场,出境,630,13,42,685
2020-12-23,高铁西九龙,入境,0,0,0,0
2020-12-23,高铁西九龙,出境,0,0,0,0
2020-12-23,红磡,入境,0,0,0,0
2020-12-23,红磡,出境,0,0,0,0
2020-12-23,罗湖,入境,0,0,0,0
2020-12-23,罗湖,出境,0,0,0,0
2020-12-23,落马洲支线,入境,0,0,0,0
2020-12-23,落马洲支线,出境,0,0,0,0
2020-12-23,香园围,入境,0,0,0,0
2020-12-23,香园围,出境,0,0,0,0
2020-12-23,港珠澳大桥,入境,102,1,7,110
2020-12-23,港珠澳大桥,出境,247,13,7,267
2020-12-23,落马洲,入境,0,0,0,0
2020-12-23,落马洲,出境,0,0,0,0
2020-12-23,文锦渡,入境,0,0,0,0
2020-12-23,文锦渡,出境,0,0,0,0
2020-12-23,沙头角,入境,0,0,0,0
2020-12-23,沙头角,出境,0,0,0,0
2020-12-23,深圳湾,入境,1131,72,2,1205
2020-12-23,深圳湾,出境,2643,272,2,2917
2020-12-23,中国客运码头,入境,0,0,0,0
2020-12-23,中国客运码头,出境,0,0,0,0
2020-12-23,港口管制,入境,0,0,0,0
2020-12-23,港口管制,出境,0,0,0,0
2020-12-23,启德邮轮码头,入境,0,0,0,0
2020-12-23,启德邮轮码头,出境,0,0,0,0
2020-12-23,港澳客轮码头,入境,0,0,0,0
2020-12-23,港澳客轮码头,出境,0,0,0,0
2020-12-23,屯门客运码头,入境,0,0,0,0
2020-12-23,屯门客运码头,出境,0,0,0,0
2020-12-24,机场,入境,337,2,23,362
2020-12-24,机场,出境,665,6,36,707
2020-12-24,高铁西九龙,入境,0,0,0,0
2020-12-24,高铁西九龙,出境,0,0,0,0
2020-12-24,红磡,入境,0,0,0,0
2020-12-24,红磡,出境,0,0,0,0
2020-12-24,罗湖,入境,0,0,0,0
2020-12-24,罗湖,出境,0,0,0,0
2020-12-24,落马洲支线,入境,0,0,0,0
2020-12-24,落马洲支线,出境,0,0,0,0
2020-12-24,香园围,入境,0,0,0,0
2020-12-24,香园围,出境,0,0,0,0
2020-12-24,港珠澳大桥,入境,68,2,0,70
2020-12-24,港珠澳大桥,出境,248,10,7,265
2020-12-24,落马洲,入境,0,0,0,0
2020-12-24,落马洲,出境,0,0,0,0
2020-12-24,文锦渡,入境,0,0,0,0
2020-12-24,文锦渡,出境,0,0,0,0
2020-12-24,沙头角,入境,0,0,0,0
2020-12-24,沙头角,出境,0,0,0,0
2020-12-24,深圳湾,入境,1005,66,4,1075
2020-12-24,深圳湾,出境,2400,254,2,2656
2020-12-24,中国客运码头,入境,0,0,0,0
2020-12-24,中国客运码头,出境,0,0,0,0
2020-12-24,港口管制,入境,0,0,0,0
2020-12-24,港口管制,出境,0,0,0,0
2020-12-24,启德邮轮码头,入境,0,0,0,0
2020-12-24,启德邮轮码头,出境,0,0,0,0
2020-12-24,港澳客轮码头,入境,0,0,0,0
2020-12-24,港澳客轮码头,出境,0,0,0,0
2020-12-24,屯门客运码头,入境,0,0,0,0
2020-12-24,屯门客运码头,出境,0,0,0,0
2020-12-25,机场,入境,367,1,11,379
2020-12-25,机场,出境,787,32,26,845
2020-12-25,高铁西九龙,入境,0,0,0,0
2020-12-25,高铁西九龙,出境,0,0,0,0
2020-12-25,红磡,入境,0,0,0,0
2020-12-25,红磡,出境,0,0,0,0
2020-12-25,罗湖,入境,0,0,0,0
2020-12-25,罗湖,出境,0,0,0,0
2020-12-25,落马洲支线,入境,0,0,0,0
2020-12-25,落马洲支线,出境,0,0,0,0
2020-12-25,香园围,入境,0,0,0,0
2020-12-25,香园围,出境,0,0,0,0
2020-12-25,港珠澳大桥,入境,35,0,1,36
2020-12-25,港珠澳大桥,出境,217,10,5,232
2020-12-25,落马洲,入境,0,0,0,0
2020-12-25,落马洲,出境,0,0,0,0
2020-12-25,文锦渡,入境,0,0,0,0
2020-12-25,文锦渡,出境,0,0,0,0
2020-12-25,沙头角,入境,0,0,0,0
2020-12-25,沙头角,出境,0,0,0,0
2020-12-25,深圳湾,入境,531,44,1,576
2020-12-25,深圳湾,出境,1671,205,2,1878
2020-12-25,中国客运码头,入境,0,0,0,0
2020-12-25,中国客运码头,出境,0,0,0,0
2020-12-25,港口管制,入境,0,0,0,0
2020-12-25,港口管制,出境,0,0,0,0
2020-12-25,启德邮轮码头,入境,0,0,0,0
2020-12-25,启德邮轮码头,出境,0,0,0,0
2020-12-25,港澳客轮码头,入境,0,0,0,0
2020-12-25,港澳客轮码头,出境,0,0,0,0
2020-12-25,屯门客运码头,入境,0,0,0,0
2020-12-25,屯门客运码头,出境,0,0,0,0
2020-12-26,机场,入境,186,3,5,194
2020-12-26,机场,出境,602,8,29,639
2020-12-26,高铁西九龙,入境,0,0,0,0
2020-12-26,高铁西九龙,出境,0,0,0,0
2020-12-26,红磡,入境,0,0,0,0
2020-12-26,红磡,出境,0,0,0,0
2020-12-26,罗湖,入境,0,0,0,0
2020-12-26,罗湖,出境,0,0,0,0
2020-12-26,落马洲支线,入境,0,0,0,0
2020-12-26,落马洲支线,出境,0,0,0,0
2020-12-26,香园围,入境,0,0,0,0
2020-12-26,香园围,出境,0,0,0,0
2020-12-26,港珠澳大桥,入境,39,4,1,44
2020-12-26,港珠澳大桥,出境,224,4,1,229
2020-12-26,落马洲,入境,0,0,0,0
2020-12-26,落马洲,出境,0,0,0,0
2020-12-26,文锦渡,入境,0,0,0,0
2020-12-26,文锦渡,出境,0,0,0,0
2020-12-26,沙头角,入境,0,0,0,0
2020-12-26,沙头角,出境,0,0,0,0
2020-12-26,深圳湾,入境,620,48,3,671
2020-12-26,深圳湾,出境,1051,129,1,1181
2020-12-26,中国客运码头,入境,0,0,0,0
2020-12-26,中国客运码头,出境,0,0,0,0
2020-12-26,港口管制,入境,0,0,0,0
2020-12-26,港口管制,出境,0,0,0,0
2020-12-26,启德邮轮码头,入境,0,0,0,0
2020-12-26,启德邮轮码头,出境,0,0,0,0
2020-12-26,港澳客轮码头,入境,0,0,0,0
2020-12-26,港澳客轮码头,出境,0,0,0,0
2020-12-26,屯门客运码头,入境,0,0,0,0
2020-12-26,屯门客运码头,出境,0,0,0,0
2020-12-27,机场,入境,515,1,27,543
2020-12-27,机场,出境,925,16,43,984
2020-12-27,高铁西九龙,入境,0,0,0,0
2020-12-27,高铁西九龙,出境,0,0,0,0
2020-12-27,红磡,入境,0,0,0,0
2020-12-27,红磡,出境,0,0,0,0
2020-12-27,罗湖,入境,0,0,0,0
2020-12-27,罗湖,出境,0,0,0,0
2020-12-27,落马洲支线,入境,0,0,0,0
2020-12-27,落马洲支线,出境,0,0,0,0
2020-12-27,香园围,入境,0,0,0,0
2020-12-27,香园围,出境,0,0,0,0
2020-12-27,港珠澳大桥,入境,64,1,1,66
2020-12-27,港珠澳大桥,出境,223,11,6,240
2020-12-27,落马洲,入境,0,0,0,0
2020-12-27,落马洲,出境,0,0,0,0
2020-12-27,文锦渡,入境,0,0,0,0
2020-12-27,文锦渡,出境,0,0,0,0
2020-12-27,沙头角,入境,0,0,0,0
2020-12-27,沙头角,出境,0,0,0,0
2020-12-27,深圳湾,入境,563,49,3,615
2020-12-27,深圳湾,出境,806,85,0,891
2020-12-27,中国客运码头,入境,0,0,0,0
2020-12-27,中国客运码头,出境,0,0,0,0
2020-12-27,港口管制,入境,0,0,0,0
2020-12-27,港口管制,出境,0,0,0,0
2020-12-27,启德邮轮码头,入境,0,0,0,0
2020-12-27,启德邮轮码头,出境,0,0,0,0
2020-12-27,港澳客轮码头,入境,0,0,0,0
2020-12-27,港澳客轮码头,出境,0,0,0,0
2020-12-27,屯门客运码头,入境,0,0,0,0
2020-12-27,屯门客运码头,出境,0,0,0,0
2020-12-28,机场,入境,222,2,12,236
2020-12-28,机场,出境,595,10,28,633
2020-12-28,高铁西九龙,入境,0,0,0,0
2020-12-28,高铁西九龙,出境,0,0,0,0
2020-12-28,红磡,入境,0,0,0,0
2020-12-28,红磡,出境,0,0,0,0
2020-12-28,罗湖,入境,0,0,0,0
2020-12-28,罗湖,出境,0,0,0,0
2020-12-28,落马洲支线,入境,0,0,0,0
2020-12-28,落马洲支线,出境,0,0,0,0
2020-12-28,香园围,入境,0,0,0,0
2020-12-28,香园围,出境,0,0,0,0
2020-12-28,港珠澳大桥,入境,126,0,2,128
2020-12-28,港珠澳大桥,出境,240,9,4,253
2020-12-28,落马洲,入境,0,0,0,0
2020-12-28,落马洲,出境,0,0,0,0
2020-12-28,文锦渡,入境,0,0,0,0
2020-12-28,文锦渡,出境,0,0,0,0
2020-12-28,沙头角,入境,0,0,0,0
2020-12-28,沙头角,出境,0,0,0,0
2020-12-28,深圳湾,入境,1156,50,2,1208
2020-12-28,深圳湾,出境,1125,90,0,1215
2020-12-28,中国客运码头,入境,0,0,0,0
2020-12-28,中国客运码头,出境,0,0,0,0
2020-12-28,港口管制,入境,0,0,0,0
2020-12-28,港口管制,出境,0,0,0,0
2020-12-28,启德邮轮码头,入境,0,0,0,0
2020-12-28,启德邮轮码头,出境,0,0,0,0
2020-12-28,港澳客轮码头,入境,0,0,0,0
2020-12-28,港澳客轮码头,出境,0,0,0,0
2020-12-28,屯门客运码头,入境,0,0,0,0
2020-12-28,屯门客运码头,出境,0,0,0,0
2020-12-29,机场,入境,408,4,9,421
2020-12-29,机场,出境,943,38,31,1012
2020-12-29,高铁西九龙,入境,0,0,0,0
2020-12-29,高铁西九龙,出境,0,0,0,0
2020-12-29,红磡,入境,0,0,0,0
2020-12-29,红磡,出境,0,0,0,0
2020-12-29,罗湖,入境,0,0,0,0
2020-12-29,罗湖,出境,0,0,0,0
2020-12-29,落马洲支线,入境,0,0,0,0
2020-12-29,落马洲支线,出境,0,0,0,0
2020-12-29,香园围,入境,0,0,0,0
2020-12-29,香园围,出境,0,0,0,0
2020-12-29,港珠澳大桥,入境,90,4,1,95
2020-12-29,港珠澳大桥,出境,247,16,2,265
2020-12-29,落马洲,入境,0,0,0,0
2020-12-29,落马洲,出境,0,0,0,0
2020-12-29,文锦渡,入境,0,0,0,0
2020-12-29,文锦渡,出境,0,0,0,0
2020-12-29,沙头角,入境,0,0,0,0
2020-12-29,沙头角,出境,0,0,0,0
2020-12-29,深圳湾,入境,731,39,3,773
2020-12-29,深圳湾,出境,1709,181,4,1894
2020-12-29,中国客运码头,入境,0,0,0,0
2020-12-29,中国客运码头,出境,0,0,0,0
2020-12-29,港口管制,入境,0,0,0,0
2020-12-29,港口管制,出境,0,0,0,0
2020-12-29,启德邮轮码头,入境,0,0,0,0
2020-12-29,启德邮轮码头,出境,0,0,0,0
2020-12-29,港澳客轮码头,入境,0,0,0,0
2020-12-29,港澳客轮码头,出境,0,0,0,0
2020-12-29,屯门客运码头,入境,0,0,0,0
2020-12-29,屯门客运码头,出境,0,0,0,0
2020-12-30,机场,入境,648,3,23,674
2020-12-30,机场,出境,656,3,48,707
2020-12-30,高铁西九龙,入境,0,0,0,0
2020-12-30,高铁西九龙,出境,0,0,0,0
2020-12-30,红磡,入境,0,0,0,0
2020-12-30,红磡,出境,0,0,0,0
2020-12-30,罗湖,入境,0,0,0,0
2020-12-30,罗湖,出境,0,0,0,0
2020-12-30,落马洲支线,入境,0,0,0,0
2020-12-30,落马洲支线,出境,0,0,0,0
2020-12-30,香园围,入境,0,0,0,0
2020-12-30,香园围,出境,0,0,0,0
2020-12-30,港珠澳大桥,入境,75,1,3,79
2020-12-30,港珠澳大桥,出境,220,12,4,236
2020-12-30,落马洲,入境,0,0,0,0
2020-12-30,落马洲,出境,0,0,0,0
2020-12-30,文锦渡,入境,0,0,0,0
2020-12-30,文锦渡,出境,0,0,0,0
2020-12-30,沙头角,入境,0,0,0,0
2020-12-30,沙头角,出境,0,0,0,0
2020-12-30,深圳湾,入境,745,58,3,806
2020-12-30,深圳湾,出境,1896,179,0,2075
2020-12-30,中国客运码头,入境,0,0,0,0
2020-12-30,中国客运码头,出境,0,0,0,0
2020-12-30,港口管制,入境,0,0,0,0
2020-12-30,港口管制,出境,0,0,0,0
2020-12-30,启德邮轮码头,入境,0,0,0,0
2020-12-30,启德邮轮码头,出境,0,0,0,0
2020-12-30,港澳客轮码头,入境,0,0,0,0
2020-12-30,港澳客轮码头,出境,0,0,0,0
2020-12-30,屯门客运码头,入境,0,0,0,0
2020-12-30,屯门客运码头,出境,0,0,0,0
2020-12-31,机场,入境,317,1,17,335
2020-12-31,机场,出境,751,5,42,798
2020-12-31,高铁西九龙,入境,0,0,0,0
2020-12-31,高铁西九龙,出境,0,0,0,0
2020-12-31,红磡,入境,0,0,0,0
2020-12-31,红磡,出境,0,0,0,0
2020-12-31,罗湖,入境,0,0,0,0
2020-12-31,罗湖,出境,0,0,0,0
2020-12-31,落马洲支线,入境,0,0,0,0
2020-12-31,落马洲支线,出境,0,0,0,0
2020-12-31,香园围,入境,0,0,0,0
2020-12-31,香园围,出境,0,0,0,0
2020-12-31,港珠澳大桥,入境,56,1,1,58
2020-12-31,港珠澳大桥,出境,215,16,2,233
2020-12-31,落马洲,入境,0,0,0,0
2020-12-31,落马洲,出境,0,0,0,0
2020-12-31,文锦渡,入境,0,0,0,0
2020-12-31,文锦渡,出境,0,0,0,0
2020-12-31,沙头角,入境,0,0,0,0
2020-12-31,沙头角,出境,0,0,0,0
2020-12-31,深圳湾,入境,633,50,4,687
2020-12-31,深圳湾,出境,2281,218,7,2506
2020-12-31,中国客运码头,入境,0,0,0,0
2020-12-31,中国客运码头,出境,0,0,0,0
2020-12-31,港口管制,入境,0,0,0,0
2020-12-31,港口管制,出境,0,0,0,0
2020-12-31,启德邮轮码头,入境,0,0,0,0
2020-12-31,启德邮轮码头,出境,0,0,0,0
2020-12-31,港澳客轮码头,入境,0,0,0,0
2020-12-31,港澳客轮码头,出境,0,0,0,0
2020-12-31,屯门客运码头,入境,0,0,0,0
2020-12-31,屯门客运码头,出境,0,0,0,0
